,date,close,high,low,open,volume,change_in_price,down_days,up_days,RSI,low_14,high_14,k_percent,r_percent,MACD,MACD_EMA,Price_Rate_Of_Change,On Balance Volume,Name
13,18-01-2013,822.7,825.8,808.75,810.8,2486485,15.1,0,15.1,48.20656702,805.05,850.9,38.49509269,-61.50490731,-2.532759018,-1.850398982,-0.000303785,-10463189,HDFC
14,21-01-2013,812.5,827.3,808.5,826.5,2478734,-10.2,10.2,0,41.12982749,805.05,850.9,16.24863686,-83.75136314,-2.879037813,-2.063629117,-0.033083423,-12941923,HDFC
15,22-01-2013,813.35,816.7,806.1,811,1304340,0.85,0,0.85,41.94923811,805.05,850.9,18.10250818,-81.89749182,-3.054053432,-2.267451057,-0.020060241,-11637583,HDFC
16,23-01-2013,820.85,824.5,814.05,816.8,1622650,7.5,0,7.5,49.15448952,805.05,845,39.5494368,-60.4505632,-2.685492548,-2.352985418,-0.00563295,-10014933,HDFC
17,24-01-2013,807.65,821.9,804.75,817.15,1456875,-13.2,13.2,0,39.25893195,804.75,845,7.204968944,-92.79503106,-3.202524989,-2.526010271,-0.002285361,-11471808,HDFC
18,25-01-2013,805.85,811.65,795.2,807.8,2213190,-1.8,1.8,0,38.05356599,795.2,845,21.38554217,-78.61445783,-3.676384196,-2.759449266,-0.025633275,-13684998,HDFC
19,28-01-2013,801.7,813,796.35,809,2799611,-4.15,4.15,0,35.18013091,795.2,845,13.05220884,-86.94779116,-4.267761063,-3.064630121,-0.028831012,-16484609,HDFC
20,29-01-2013,802.5,808.7,792.35,801.05,3887598,0.8,0,0.8,36.2508371,792.35,835.45,23.54988399,-76.45011601,-4.620596572,-3.378720383,-0.019967027,-12597011,HDFC
21,30-01-2013,797.15,806.45,792.95,806,1650024,-5.35,5.35,0,32.15265957,792.35,834.5,11.38790036,-88.61209964,-5.197567581,-3.74519392,-0.012939574,-14247035,HDFC
22,31-01-2013,786.55,802.75,784.55,794,2753902,-10.6,10.6,0,25.54945976,784.55,834.5,4.004004004,-95.995996,-6.303560382,-4.259905533,-0.043940683,-17000937,HDFC
23,01-02-2013,777.95,790,773.8,787,2585707,-8.6,8.6,0,21.42952312,773.8,832.5,7.069846678,-92.93015332,-7.679381604,-4.947045675,-0.042523077,-19586644,HDFC
24,04-02-2013,798.25,802,780,782.4,2623535,20.3,0,20.3,45.40653153,773.8,832,42.01030928,-57.98969072,-7.248009915,-5.408983676,-0.018565193,-16963109,HDFC
25,05-02-2013,797.4,800.9,791.5,791.55,1755998,-0.85,0.85,0,44.74679829,773.8,827.3,44.11214953,-55.88785047,-6.886951969,-5.70547342,-0.028567948,-18719107,HDFC
26,06-02-2013,807.75,818,802.9,803.5,3296270,10.35,0,10.35,54.11381546,773.8,827.3,63.45794393,-36.54205607,-5.791532067,-5.722726865,0.000123816,-15422837,HDFC
27,07-02-2013,810.65,821.75,801.85,805,2239647,2.9,0,2.9,56.49809774,773.8,827.3,68.87850467,-31.12149533,-4.662533839,-5.510277323,0.005956444,-13183190,HDFC
28,08-02-2013,808.8,820.9,805.15,808.5,1193807,-1.85,1.85,0,54.41681778,773.8,824.5,69.03353057,-30.96646943,-3.860790489,-5.179868673,0.008856181,-14376997,HDFC
29,11-02-2013,800.2,810.85,796.35,809.1,1884674,-8.6,8.6,0,45.43849449,773.8,824.5,52.07100592,-47.92899408,-3.814708353,-4.906498193,-0.002866044,-16261671,HDFC
30,12-02-2013,800.4,806.9,795.25,800,1626711,0.2,0,0.2,45.67899133,773.8,821.9,55.3014553,-44.6985447,-3.719891823,-4.668941654,0.004077024,-14634960,HDFC
31,13-02-2013,815,817.3,802.65,805,2833733,14.6,0,14.6,60.38644812,773.8,821.75,85.92283629,-14.07716371,-2.528064755,-4.24042677,0.036170619,-11801227,HDFC
32,14-02-2013,816.2,820.5,809.65,813,2234677,1.2,0,1.2,61.37814552,773.8,821.75,88.42544317,-11.57455683,-1.478448741,-3.68768082,0.049167684,-9566550,HDFC
33,15-02-2013,812.1,820.25,809,813,1799707,-4.1,4.1,0,55.86469663,773.8,821.75,79.87486966,-20.12513034,-0.946044952,-3.13907547,0.017350454,-11366257,HDFC
34,18-02-2013,824.45,827,805.65,812,1646991,12.35,0,12.35,66.36555616,773.8,827,95.20676692,-4.793233083,0.405552225,-2.42986224,0.033922749,-9719266,HDFC
35,19-02-2013,823.45,828.4,818,824.8,1009849,-1,1,0,64.92239701,773.8,828.4,90.93406593,-9.065934066,1.382929484,-1.667056351,0.019436707,-10729115,HDFC
36,20-02-2013,819.6,828.3,815.55,826.9,1520492,-3.85,3.85,0,59.20331708,773.8,828.4,83.88278388,-16.11721612,1.840895574,-0.965283775,0.011040523,-12249607,HDFC
37,21-02-2013,815.05,820,811.3,815,1910813,-4.55,4.55,0,52.85424747,780,828.4,72.41735537,-27.58264463,1.833025486,-0.405505662,0.007727498,-14160420,HDFC
38,22-02-2013,799.85,811.95,791,811,2776078,-15.2,15.2,0,37.3957723,791,828.4,23.6631016,-76.3368984,0.648709528,-0.194627586,-0.000437391,-16936498,HDFC
39,25-02-2013,802.05,810.35,793,802,2342812,2.2,0,2.2,40.31122772,791,828.4,29.54545455,-70.45454545,-0.117652181,-0.179230458,0.002061469,-14593686,HDFC
40,26-02-2013,771.55,800,765.95,800,3054510,-30.5,30.5,0,23.10163652,765.95,828.4,8.967173739,-91.03282626,-3.053655823,-0.75417667,-0.053312883,-17648196,HDFC
41,27-02-2013,779.35,788.2,775,775.25,2791737,7.8,0,7.8,31.70513788,765.95,828.4,21.45716573,-78.54283427,-4.717586795,-1.546926134,-0.045148248,-14856459,HDFC
42,28-02-2013,757.65,787.3,750,781.1,5699724,-21.7,21.7,0,23.32724756,750,828.4,9.757653061,-90.24234694,-7.638896117,-2.765403056,-0.067048393,-20556183,HDFC
43,01-03-2013,777.5,782.5,756,757,3069695,19.85,0,19.85,40.04804717,750,828.4,35.07653061,-64.92346939,-8.304801188,-3.873343005,-0.056947056,-17486488,HDFC
44,04-03-2013,773.8,782.15,768.4,771.25,2996969,-3.7,3.7,0,38.25381018,750,828.4,30.35714286,-69.64285714,-9.017739719,-4.902267163,-0.0602951,-20483457,HDFC
45,05-03-2013,773.1,785.8,768.85,776.35,3283252,-0.7,0.7,0,37.88330816,750,828.4,29.46428571,-70.53571429,-9.527152283,-5.827276419,-0.056734993,-23766709,HDFC
46,06-03-2013,774.3,780,766.35,775.2,1724891,1.2,0,1.2,39.05096131,750,828.4,30.99489796,-69.00510204,-9.723726775,-6.606588214,-0.049996933,-22041818,HDFC
47,07-03-2013,782.05,786.35,767.15,771.05,1172991,7.75,0,7.75,46.53964882,750,828.4,40.88010204,-59.11989796,-9.162461985,-7.117774368,-0.022254173,-20868827,HDFC
48,08-03-2013,813.25,816,786.35,788.85,2909910,31.2,0,31.2,65.96490098,750,828.4,80.67602041,-19.32397959,-6.182352997,-6.930686756,0.013964217,-17958917,HDFC
49,11-03-2013,831.65,835.9,813.25,813.25,4448888,18.4,0,18.4,72.71200767,750,835.9,95.0523865,-4.947613504,-2.338822164,-6.01230073,0.077895146,-13510029,HDFC
50,12-03-2013,823.8,838.55,819.1,832.5,2338597,-7.85,7.85,0,66.24716992,750,838.55,83.34274421,-16.65725579,0.083578329,-4.793110998,0.057034708,-15848626,HDFC
51,13-03-2013,809.2,820.9,805.2,818,1187124,-14.6,14.6,0,55.6324039,750,838.55,66.85488425,-33.14511575,0.835083527,-3.667461811,0.068039332,-17035750,HDFC
52,14-03-2013,814.1,820,797.75,806.25,3594813,4.9,0,4.9,58.22452689,750,838.55,72.38848108,-27.61151892,1.798924761,-2.574176507,0.047073955,-13440937,HDFC
53,15-03-2013,817.3,831.5,812.8,815.15,3180451,3.2,0,3.2,59.98610668,750,838.55,76.00225861,-23.99774139,2.784908201,-1.5023533,0.056216077,-10260486,HDFC
54,18-03-2013,810.1,816,806,807,1361589,-7.2,7.2,0,54.06715388,750,838.55,67.87125918,-32.12874082,2.958818533,-0.61011476,0.047859268,-11622075,HDFC
55,19-03-2013,784.55,814.85,779.65,814.4,3612409,-25.55,25.55,0,38.50888022,750,838.55,39.01750423,-60.98249577,1.048519463,-0.278386674,0.013237763,-15234484,HDFC
56,20-03-2013,780.4,795.85,776.95,790.8,4001852,-4.15,4.15,0,36.53835505,756,838.55,29.55784373,-70.44215627,-0.787096036,-0.380128851,-0.00210984,-19236336,HDFC
57,21-03-2013,797.9,812.75,778.05,780,3606383,17.5,0,17.5,49.18909403,766.35,838.55,43.69806094,-56.30193906,-0.834973288,-0.471097956,-0.018874885,-15629953,HDFC
58,22-03-2013,796.4,806.1,789.6,795,2652295,-1.5,1.5,0,48.23806115,766.35,838.55,41.62049861,-58.37950139,-0.981420389,-0.573162639,-0.042385619,-18282248,HDFC
59,25-03-2013,806.2,818.9,801.2,811.9,3742041,9.8,0,9.8,54.82267012,766.35,838.55,55.19390582,-44.80609418,-0.310349639,-0.520599958,-0.021364409,-14540207,HDFC
60,26-03-2013,824.2,827.5,804.1,804.1,3355398,18,0,18,64.41598569,767.15,838.55,79.90196078,-20.09803922,1.642592425,-0.087960951,0.018536826,-11184809,HDFC
61,28-03-2013,826.25,830,805.2,828.7,3393019,2.05,0,2.05,65.38199102,776.95,838.55,80.03246753,-19.96753247,3.316008618,0.592833631,0.014924456,-7791790,HDFC
62,01-04-2013,825.2,835.4,817.95,826.8,1514565,-1.05,1.05,0,64.34957763,776.95,838.55,78.32792208,-21.67207792,4.505971852,1.375461889,0.009665973,-9306355,HDFC
63,02-04-2013,817.25,827.5,812.6,826.35,1303041,-7.95,7.95,0,56.548694,776.95,838.55,65.42207792,-34.57792208,4.756876109,2.051745157,0.008826071,-10609396,HDFC
64,03-04-2013,811.65,817.25,803.05,817,1555063,-5.6,5.6,0,51.476712,776.95,835.4,59.36698033,-40.63301967,4.455239458,2.532444259,0.034542094,-12164459,HDFC
65,04-04-2013,792.35,808.45,789.15,805,1416731,-19.3,19.3,0,37.94329749,776.95,835.4,26.34730539,-73.65269461,2.637417562,2.553438928,0.01531266,-13581190,HDFC
66,05-04-2013,770.8,789.9,763.1,787.45,2879146,-21.55,21.55,0,28.34307295,763.1,835.4,10.65006916,-89.34993084,-0.526661531,1.937418638,-0.033964156,-16460336,HDFC
67,08-04-2013,758.2,778.95,756.75,770,1174876,-12.6,12.6,0,24.21049408,756.75,835.4,1.843610935,-98.15638907,-3.999611059,0.750012393,-0.047965846,-17635212,HDFC
68,09-04-2013,752.95,775,750.1,766,1754228,-5.25,5.25,0,22.6245399,750.1,835.4,3.341148886,-96.65885111,-7.091680836,-0.818326575,-0.066050608,-19389440,HDFC
69,10-04-2013,783.15,788,755.25,760,3306254,30.2,0,30.2,46.0720391,750.1,835.4,38.74560375,-61.25439625,-7.034355966,-2.061532658,-0.049805872,-16083186,HDFC
70,11-04-2013,763.6,782,759.2,778.75,3921034,-19.55,19.55,0,37.56841772,750.1,835.4,15.82649472,-84.17350528,-8.462636816,-3.341753658,-0.075824508,-20004220,HDFC
71,12-04-2013,764.8,772.8,761.8,765.1,3041673,1.2,0,1.2,38.3740054,750.1,835.4,17.23329426,-82.76670574,-9.389730992,-4.551349252,-0.073194377,-16962547,HDFC
72,15-04-2013,774.9,790,766.1,766.9,2806499,10.1,0,10.1,45.23657986,750.1,835.4,29.07385698,-70.92614302,-9.206011147,-5.48228171,-0.051820128,-14156048,HDFC
73,16-04-2013,803.7,807.3,772.4,777,2266442,28.8,0,28.8,59.92105503,750.1,835.4,62.83704572,-37.16295428,-6.666854752,-5.719196334,-0.009794862,-11889606,HDFC
74,17-04-2013,790.4,817.2,785.55,806,3284433,-13.3,13.3,0,52.42982196,750.1,835.4,47.24501758,-52.75498242,-5.659452102,-5.707247487,-0.002461034,-15174039,HDFC
75,18-04-2013,818.25,821,795,795,3193433,27.85,0,27.85,63.46548965,750.1,835.4,79.89449004,-20.10550996,-2.589980005,-5.083793964,0.061559419,-11980606,HDFC
76,22-04-2013,835.6,839,816.95,819,2115449,17.35,0,17.35,68.68715002,750.1,839,96.17547807,-3.824521935,1.224938247,-3.822047478,0.102083883,-9865157,HDFC
77,23-04-2013,838.1,844.8,823.65,838,1225389,2.5,0,2.5,69.41395368,750.1,844.8,92.9250264,-7.074973601,4.398751138,-2.17788771,0.113088518,-8639768,HDFC
78,25-04-2013,862.75,885.4,838.55,843.5,5182930,24.65,0,24.65,75.80352165,750.1,885.4,83.2594235,-16.7405765,8.79734223,0.017158327,0.10164081,-3456838,HDFC
79,26-04-2013,872.6,879.1,857.7,862.95,2560119,9.85,0,9.85,77.92936024,750.1,885.4,90.53954176,-9.460458241,12.92736389,2.599199486,0.142744893,-896719,HDFC
80,29-04-2013,864.2,874.5,858,870.05,1634522,-8.4,8.4,0,71.72838311,750.1,885.4,84.33111604,-15.66888396,15.34683024,5.148725672,0.129968619,-2531241,HDFC
81,30-04-2013,847.6,870.55,843.65,863.6,2710730,-16.6,16.6,0,60.71261755,750.1,885.4,72.06208426,-27.93791574,15.74545936,7.268072434,0.093818557,-5241971,HDFC
82,02-05-2013,863.45,870.9,845.65,845.65,2976406,15.85,0,15.85,66.39797953,755.25,885.4,83.13484441,-16.86515559,17.14070001,9.242597967,0.074343661,-2265565,HDFC
83,03-05-2013,854.9,862,845.2,859.8,2059570,-8.55,8.55,0,60.91155432,759.2,885.4,75.83201268,-24.16798732,17.35737066,10.86555252,0.081604251,-4325135,HDFC
84,06-05-2013,852.65,861.35,845.5,858,1186405,-2.25,2.25,0,59.4206951,761.8,885.4,73.50323625,-26.49676375,17.15002941,12.1224479,0.042040941,-5511540,HDFC
85,07-05-2013,853.75,860.8,841.3,854.25,3260999,1.1,0,1.1,59.97333776,766.1,885.4,73.47024308,-26.52975692,16.87974442,13.07390721,0.021720919,-2250541,HDFC
86,08-05-2013,885,895,852,859.75,3070552,31.25,0,31.25,72.32710944,772.4,895,91.84339315,-8.156606852,18.9656027,14.25224631,0.055959909,820011,HDFC
87,09-05-2013,880.35,900.85,876.3,893,2182837,-4.65,4.65,0,68.68730931,785.55,900.85,82.22029488,-17.77970512,20.01308416,15.40441389,0.020399884,-1362826,HDFC
88,10-05-2013,877.3,882.15,863.1,880,2659090,-3.05,3.05,0,66.16723019,795,900.85,77.75153519,-22.24846481,20.36257888,16.39604689,0.005386202,-4021916,HDFC
89,11-05-2013,874.5,880,869.35,875,76194,-2.8,2.8,0,63.69192833,816.95,900.85,68.59356377,-31.40643623,20.18115155,17.15306782,0.011918537,-4098110,HDFC
90,13-05-2013,863.5,876.8,859.6,875,1652780,-11,11,0,54.45721896,823.65,900.85,51.61917098,-48.38082902,18.93224088,17.50890243,0.018758849,-5750890,HDFC
91,14-05-2013,870.85,873,855.25,864.7,2017078,7.35,0,7.35,59.03632126,838.55,900.85,51.8459069,-48.1540931,18.32384672,17.67189129,0.00857027,-3733812,HDFC
92,15-05-2013,910.05,915.95,875,876.8,5682986,39.2,0,39.2,74.69407929,841.3,915.95,92.0964501,-7.9035499,20.76314841,18.29014272,0.064510469,1949174,HDFC
93,16-05-2013,908.35,917.5,903.7,909.8,4700244,-1.7,1.7,0,73.29223635,841.3,917.5,87.99212598,-12.00787402,22.30210097,19.09253437,0.065325749,-2751070,HDFC
94,17-05-2013,903.35,908,898.3,904,2665794,-5,5,0,68.90365235,841.3,917.5,81.43044619,-18.56955381,22.8550297,19.84503344,0.058096633,-5416864,HDFC
95,20-05-2013,898.4,916.7,895,903,2658730,-4.95,4.95,0,64.49243633,841.3,917.5,74.9343832,-25.0656168,22.63310725,20.4026482,0.015141243,-8075594,HDFC
96,21-05-2013,902.05,908.8,890.1,895.15,3095064,3.65,0,3.65,66.32660216,841.3,917.5,79.72440945,-20.27559055,22.49230137,20.82057883,0.024649287,-4980530,HDFC
97,22-05-2013,899.85,904,894.1,903.8,1971551,-2.2,2.2,0,64.02645868,841.3,917.5,76.83727034,-23.16272966,21.95022888,21.04650884,0.025703864,-6952081,HDFC
98,23-05-2013,903.15,913.8,892.15,892.15,3458455,3.3,0,3.3,66.06338299,841.3,917.5,81.167979,-18.832021,21.53849496,21.14490606,0.032761578,-3493626,HDFC
99,24-05-2013,906.05,910.15,899.35,908,2830814,2.9,0,2.9,67.90604989,852,917.5,82.51908397,-17.48091603,21.20168475,21.1562618,0.049276202,-662812,HDFC
100,27-05-2013,929.5,931.4,898.65,901.6,2443669,23.45,0,23.45,78.69785974,855.25,931.4,97.50492449,-2.495075509,22.56609742,21.43822892,0.067347993,1780857,HDFC
101,28-05-2013,919.8,929.9,913.15,929.9,2347931,-9.7,9.7,0,67.81433837,855.25,931.4,84.76690742,-15.23309258,22.60438892,21.67146092,0.010713697,-567074,HDFC
102,29-05-2013,910.55,923.4,900.7,923.4,3007036,-9.25,9.25,0,58.85801028,855.25,931.4,72.61982928,-27.38017072,21.63913089,21.66499492,0.002421974,-3574110,HDFC
103,30-05-2013,926.25,929,905.1,905.1,3100217,15.7,0,15.7,67.31263298,855.25,931.4,93.23703217,-6.762967827,21.88829843,21.70965562,0.025350086,-473893,HDFC
104,31-05-2013,890.15,924,883.65,921.1,4387938,-36.1,36.1,0,43.56210553,855.25,931.4,45.8305975,-54.1694025,18.95511884,21.15874826,-0.009182992,-4861831,HDFC
105,03-06-2013,869.05,898.65,867.05,895,1870547,-21.1,21.1,0,35.18868538,867.05,931.4,3.108003108,-96.89199689,14.75828645,19.8786559,-0.036583338,-6732378,HDFC
106,04-06-2013,854.2,876.8,852,876.8,2621881,-14.85,14.85,0,30.43756693,852,931.4,2.770780856,-97.22921914,10.11766456,17.92645763,-0.050730677,-9354259,HDFC
107,05-06-2013,843.95,855,839.05,853.8,3011996,-10.25,10.25,0,27.48233381,839.05,931.4,5.305901462,-94.69409854,5.549077894,15.45098169,-0.065548359,-12366255,HDFC
108,06-06-2013,845,859.5,833.15,838.1,3198369,1.05,0,1.05,28.30511307,833.15,931.4,12.0610687,-87.9389313,1.990214198,12.75882819,-0.067380387,-9167886,HDFC
109,07-06-2013,839.35,856.35,833.35,840,1645663,-5.65,5.65,0,26.44239406,833.15,931.4,6.31043257,-93.68956743,-1.271367552,9.95278904,-0.096987628,-10813549,HDFC
110,10-06-2013,852.6,864.05,835.8,844,2583932,13.25,0,13.25,37.56107366,833.15,931.4,19.79643766,-80.20356234,-2.755454207,7.41114039,-0.073059361,-8229617,HDFC
111,11-06-2013,831.15,851.8,826.4,845.5,2677716,-21.45,21.45,0,29.29085483,826.4,931.4,4.523809524,-95.47619048,-5.597619823,4.809388348,-0.087200044,-10907333,HDFC
112,12-06-2013,820.75,830.4,816.25,830.4,2365088,-10.4,10.4,0,26.07855236,816.25,931.4,3.907946157,-96.09205384,-8.590091942,2.12949229,-0.113900135,-13272421,HDFC
113,13-06-2013,812.2,816.55,804.3,806.1,5578717,-8.55,8.55,0,23.62120209,804.3,931.4,6.215578285,-93.78442172,-11.51867516,-0.6001412,-0.087569511,-18851138,HDFC
114,14-06-2013,835,838,820,820,3666156,22.8,0,22.8,40.78863307,804.3,929.9,24.44267516,-75.55732484,-11.86331404,-2.852775767,-0.039180715,-15184982,HDFC
115,17-06-2013,844.4,855.05,831,836.1,2464128,9.4,0,9.4,46.50816991,804.3,929,32.15717723,-67.84282277,-11.24836749,-4.531894111,-0.011472723,-12720854,HDFC
116,18-06-2013,834,847,831.15,844.1,1752255,-10.4,10.4,0,41.40267792,804.3,929,23.81716119,-76.18283881,-11.46791855,-5.919098998,-0.011789798,-14473109,HDFC
117,19-06-2013,842.75,844.7,828.1,830,2567687,8.75,0,8.75,47.04594014,804.3,924,32.1219716,-67.8780284,-10.8113085,-6.8975409,-0.002662722,-11905422,HDFC
118,20-06-2013,817.55,834,812,829,3677976,-25.2,25.2,0,35.64001068,804.3,898.65,14.04345522,-85.95654478,-12.18372311,-7.954777342,-0.025972479,-15583398,HDFC
119,21-06-2013,820.7,824.15,801.3,815,2841911,3.15,0,3.15,37.81449178,801.3,876.8,25.69536424,-74.30463576,-12.86886826,-8.937595525,-0.037414966,-12741487,HDFC
120,24-06-2013,824.8,829,809.95,814.8,2917116,4.1,0,4.1,40.81748466,801.3,864.05,37.4501992,-62.5498008,-12.93196843,-9.736470106,-0.007640017,-9824371,HDFC
121,25-06-2013,817.45,834.9,810.1,826.9,2449730,-7.35,7.35,0,37.11055804,801.3,864.05,25.73705179,-74.26294821,-13.42031037,-10.47323816,-0.004020713,-12274101,HDFC
122,26-06-2013,815.6,824.35,810,818.6,2554481,-1.85,1.85,0,36.15690308,801.3,864.05,22.78884462,-77.21115538,-13.79754203,-11.13809893,0.004186161,-14828582,HDFC
123,27-06-2013,837.15,843.2,809.05,816.5,4811518,21.55,0,21.55,52.54698296,801.3,864.05,57.1314741,-42.8685259,-12.21688112,-11.35385537,0.00257485,-10017064,HDFC
124,28-06-2013,879.05,886.5,839,839,5139254,41.9,0,41.9,69.88918623,801.3,886.5,91.25586854,-8.744131455,-7.497003335,-10.58248496,0.041035054,-4877810,HDFC
125,01-07-2013,889.65,891,861,879,2565358,10.6,0,10.6,72.79174415,801.3,891,98.49498328,-1.505016722,-2.86812363,-9.039612696,0.066726619,-2312452,HDFC
126,02-07-2013,875.15,893,872.25,886.65,2166106,-14.5,14.5,0,63.17911892,801.3,893,80.53435115,-19.46564885,-0.365459555,-7.304782068,0.038445565,-4478558,HDFC
127,03-07-2013,853.6,871.6,850,870,1760408,-21.55,21.55,0,51.51349263,801.3,893,57.03380589,-42.96619411,-0.119523497,-5.867730354,0.044095162,-6238966,HDFC
128,04-07-2013,852.1,867.7,849.8,857.3,1295767,-1.5,1.5,0,50.7607365,801.3,893,55.39803708,-44.60196292,-0.045129262,-4.703210136,0.038260022,-7534733,HDFC
129,05-07-2013,850.1,859.65,848.15,859,1960980,-2,2,0,49.6446637,801.3,893,53.217012,-46.782988,-0.145866382,-3.791741385,0.030674103,-9495713,HDFC
130,08-07-2013,824.05,846.85,818,845.85,3695733,-26.05,26.05,0,37.31452072,801.3,893,24.80916031,-75.19083969,-2.30111109,-3.493615326,0.008073888,-13191446,HDFC
131,09-07-2013,830.05,832,826,826,3236206,6,0,6,41.19597121,801.3,893,31.35223555,-68.64776445,-3.484853427,-3.491862946,0.017717018,-9955240,HDFC
132,10-07-2013,827.5,834.15,822.4,833.2,3114437,-2.55,2.55,0,39.98194556,801.3,893,28.57142857,-71.42857143,-4.575984864,-3.70868733,-0.011527205,-13069677,HDFC
133,11-07-2013,854.8,856.7,834,838.5,3000215,27.3,0,27.3,55.99963224,809.05,893,54.49672424,-45.50327576,-3.201000714,-3.607150007,-0.027586599,-10069462,HDFC
134,12-07-2013,851.3,859.55,836.95,857.3,2953316,-3.5,3.5,0,53.87276468,809.05,893,50.32757594,-49.67242406,-2.366449827,-3.359009971,-0.04310684,-13022778,HDFC
135,15-07-2013,848.5,853.6,841.1,849.85,1580962,-2.8,2.8,0,52.04803918,809.05,893,46.9922573,-53.0077427,-1.908987357,-3.069005448,-0.030451923,-14603740,HDFC
136,16-07-2013,816.05,831.8,805,831.8,3665638,-32.45,32.45,0,35.82276724,805,893,12.55681818,-87.44318182,-4.117362401,-3.278676839,-0.043990159,-18269378,HDFC
137,17-07-2013,817.1,829.05,803.25,820.5,5669579,1.05,0,1.05,36.56112289,803.25,893,15.43175487,-84.56824513,-5.71688979,-3.766319429,-0.041074991,-12599799,HDFC
138,18-07-2013,829.05,835,815.2,818.5,5614744,11.95,0,11.95,44.88758602,803.25,893,28.74651811,-71.25348189,-5.951674108,-4.203390365,-0.024761793,-6985055,HDFC
139,19-07-2013,803.2,832,789.5,829.05,6622252,-25.85,25.85,0,33.81104387,789.5,893,13.23671498,-86.76328502,-8.129864522,-4.988685196,-0.025301863,-13607307,HDFC
140,22-07-2013,830.3,833.7,795.85,802.9,2146242,27.1,0,27.1,49.02634035,789.5,871.6,49.6954933,-50.3045067,-7.581990795,-5.507346316,0.000301187,-11461065,HDFC
141,23-07-2013,826.85,838.45,819.05,832,3677987,-3.45,3.45,0,47.42494189,789.5,867.7,47.76214834,-52.23785166,-7.341549493,-5.874186951,-0.000785498,-15139052,HDFC
142,24-07-2013,803.25,818.7,799.5,818.7,6483783,-23.6,23.6,0,37.70418108,789.5,859.65,19.60085531,-80.39914469,-8.952097045,-6.48976897,-0.060306504,-21622835,HDFC
143,25-07-2013,800.8,816,797.25,804.4,4837186,-2.45,2.45,0,36.8006341,789.5,859.55,16.13133476,-83.86866524,-10.30734218,-7.253283612,-0.059321038,-26460021,HDFC
144,26-07-2013,805.55,813.95,795.3,805.15,2109712,4.75,0,4.75,40.0162929,789.5,859.55,22.91220557,-77.08779443,-10.87276853,-7.977180596,-0.050618739,-24350309,HDFC
145,29-07-2013,806.6,816.8,803,803,1619897,1.05,0,1.05,40.78477581,789.5,859.55,24.4111349,-75.5888651,-11.10810022,-8.60336452,-0.011580173,-22730412,HDFC
146,30-07-2013,807.85,821,801.55,807.1,3248187,1.25,0,1.25,41.80883854,789.5,859.55,26.19557459,-73.80442541,-11.06617462,-9.095926541,-0.011320524,-19482225,HDFC
147,31-07-2013,800.45,816,794.6,807.85,5920069,-7.4,7.4,0,37.39172743,789.5,859.55,15.63169165,-84.36830835,-11.49752367,-9.576245966,-0.034497316,-25402294,HDFC
148,01-08-2013,817,825,805,805,4437968,16.55,0,16.55,50.80428703,789.5,853.6,42.90171607,-57.09828393,-10.38423395,-9.737843563,0.017181275,-20964326,HDFC
149,02-08-2013,808.35,827.3,798.4,825.7,2616340,-8.65,8.65,0,44.99159458,789.5,838.45,38.50868233,-61.49131767,-10.08368177,-9.807011205,-0.026436228,-23580666,HDFC
150,05-08-2013,798.95,817,787.2,808,2561534,-9.4,9.4,0,39.34682372,787.2,838.45,22.92682927,-77.07317073,-10.48314384,-9.942237732,-0.033742517,-26142200,HDFC
151,06-08-2013,751.85,807.55,734.85,798.45,5898868,-47.1,47.1,0,22.80494306,734.85,838.45,16.40926641,-83.59073359,-14.43388245,-10.84056668,-0.06399004,-32041068,HDFC
152,07-08-2013,729.7,759.7,723,759.7,11055713,-22.15,22.15,0,18.56888614,723,838.45,5.803378086,-94.19662191,-19.13164026,-12.49878139,-0.088786214,-43096781,HDFC
153,08-08-2013,746.95,751.5,729.7,730,6720921,17.25,0,17.25,30.21677244,723,838.45,20.74491122,-79.25508878,-21.21813552,-14.24265222,-0.072745329,-36375860,HDFC
154,12-08-2013,769.75,783.15,745,755,5599176,22.8,0,22.8,42.71365092,723,838.45,40.49372023,-59.50627977,-20.79225926,-15.55257363,-0.045685594,-30776684,HDFC
155,13-08-2013,791.95,794.6,755.45,769.85,3162116,22.2,0,22.2,52.30885614,723,827.3,66.10738255,-33.89261745,-18.45071638,-16.13220218,-0.019681872,-27614568,HDFC
156,14-08-2013,780.7,799.3,775.55,795,2636452,-11.25,11.25,0,47.6428206,723,827.3,55.32118888,-44.67881112,-17.3033408,-16.3664299,-0.024673621,-30251020,HDFC
157,16-08-2013,737.9,780.3,731,780,5354663,-42.8,42.8,0,34.23668341,723,827.3,14.28571429,-85.71428571,-19.62143906,-17.01743173,-0.096817625,-35605683,HDFC
158,19-08-2013,735.5,740.65,712.2,731,5182645,-2.4,2.4,0,33.62450574,712.2,827.3,20.24326672,-79.75673328,-21.40545862,-17.89503711,-0.090121853,-40788328,HDFC
159,20-08-2013,726.25,740.7,710.55,716,5240733,-9.25,9.25,0,31.14770934,710.55,827.3,13.44753747,-86.55246253,-23.29714632,-18.97545895,-0.09099443,-46029061,HDFC
160,21-08-2013,747.25,759.45,734,750.8,6176085,21,0,21,42.28433391,710.55,827.3,31.43468951,-68.56531049,-22.83853582,-19.74807433,-0.006118242,-39852976,HDFC
161,22-08-2013,735.9,748.85,727.2,744,3413023,-11.35,11.35,0,38.40994393,710.55,827.3,21.7130621,-78.2869379,-23.12436713,-20.42333289,0.008496642,-43265999,HDFC
162,23-08-2013,740.85,747.9,720.1,737,3793047,4.95,0,4.95,41.12460083,710.55,827.3,25.95289079,-74.04710921,-22.68991284,-20.87664888,-0.008166544,-39472952,HDFC
163,26-08-2013,744,749.8,735.45,744.25,2824008,3.15,0,3.15,42.97029086,710.55,817,31.42320338,-68.57679662,-21.83967252,-21.06925361,-0.03345242,-36648944,HDFC
164,27-08-2013,686,735,666.75,735,5956827,-58,58,0,25.7921112,666.75,807.55,13.671875,-86.328125,-25.55141208,-21.9656853,-0.133783698,-42605771,HDFC
165,28-08-2013,652.75,676.05,632.2,671.55,13780849,-33.25,33.25,0,20.39811686,632.2,799.3,12.29802513,-87.70197487,-30.82070041,-23.73668832,-0.16389138,-56386620,HDFC
166,29-08-2013,695.5,702.8,658.2,659,8304579,42.75,0,42.75,39.24693627,632.2,799.3,37.88150808,-62.11849192,-31.18757878,-25.22686641,-0.05746036,-48082041,HDFC
167,30-08-2013,718.65,733.25,698.5,700,6360989,23.15,0,23.15,47.07704323,632.2,799.3,51.73548773,-48.26451227,-29.27288546,-26.03607022,-0.022909585,-41721052,HDFC
168,02-09-2013,738.4,745,723.1,724.7,4222035,19.75,0,19.75,53.03549308,632.2,799.3,63.55475763,-36.44524237,-25.86368012,-26.0015922,0.016729776,-37499017,HDFC
169,03-09-2013,702.35,745,695.35,745,5619080,-36.05,36.05,0,42.86999434,632.2,799.3,41.98084979,-58.01915021,-25.77368539,-25.95601084,-0.060086986,-43118097,HDFC
170,04-09-2013,709.5,712.4,685.4,696,4033873,7.15,0,7.15,45.27065624,632.2,780.3,52.1944632,-47.8055368,-24.83909006,-25.73262668,-0.035874439,-39084224,HDFC
171,05-09-2013,750.4,774.9,726.7,726.7,3853912,40.9,0,40.9,57.1540756,632.2,774.9,82.83111423,-17.16888577,-20.56111797,-24.69832494,0.012890599,-35230312,HDFC
172,06-09-2013,760.85,768,730,755,3509710,10.45,0,10.45,59.73173198,632.2,774.9,90.15416959,-9.845830413,-16.14149876,-22.98695971,0.022647849,-31720602,HDFC
173,10-09-2013,809.15,816.8,776,780,7012085,48.3,0,48.3,69.51323503,632.2,816.8,95.85590466,-4.144095341,-8.641899467,-20.11794766,0.17951895,-24708517,HDFC
174,11-09-2013,811.8,816.8,787.8,808.75,4672382,2.65,0,2.65,69.97494904,632.2,816.8,97.29144095,-2.708559047,-2.456266196,-16.58561137,0.243661432,-20036135,HDFC
175,12-09-2013,814.45,825,793.5,815.5,5844709,2.65,0,2.65,70.49061652,632.2,825,94.5280083,-5.471991701,2.629414997,-12.74260609,0.171028037,-14191426,HDFC
176,13-09-2013,807.95,813.7,797.1,809.9,3841877,-6.5,6.5,0,67.22308473,632.2,825,91.156639,-8.843360996,6.065440213,-8.980996832,0.124260767,-18033303,HDFC
177,16-09-2013,814.25,828,796.05,828,3154105,6.3,0,6.3,68.83849216,632.2,828,92.97752809,-7.02247191,9.190924465,-5.346612573,0.102722102,-14879198,HDFC
178,17-09-2013,803.95,808.55,796.4,807,2827630,-10.3,10.3,0,62.98277155,632.2,828,87.71705822,-12.28294178,10.71327413,-2.134635231,0.144657222,-17706828,HDFC
179,18-09-2013,799.2,808.9,780,807,4697409,-4.75,4.75,0,60.25537021,658.2,828,83.03886926,-16.96113074,11.40499257,0.573290328,0.126427061,-22404237,HDFC
180,19-09-2013,834.55,843.6,822.5,839,12423950,35.35,0,35.35,71.02850156,685.4,843.6,94.27939317,-5.720606827,14.63690644,3.386013551,0.112140192,-9980287,HDFC
181,20-09-2013,810.4,843.2,784.35,836,19090820,-24.15,24.15,0,58.52384012,685.4,843.6,79.01390645,-20.98609355,15.07573605,5.723958051,0.065124532,-29071107,HDFC
182,23-09-2013,776.2,796.25,770,792,5102555,-34.2,34.2,0,45.44937156,685.4,843.6,57.39570164,-42.60429836,12.51954195,7.083074831,-0.040721745,-34173662,HDFC
183,24-09-2013,788.25,796.55,765,765.15,3818752,12.05,0,12.05,49.99135134,685.4,843.6,65.01264223,-34.98735777,11.33540586,7.933541037,-0.029009608,-30354910,HDFC
184,25-09-2013,779.65,792,771.4,790,3581325,-8.6,8.6,0,46.78361595,726.7,843.6,45.29512404,-54.70487596,9.592446023,8.265322034,-0.042728221,-33936235,HDFC
185,26-09-2013,792.85,799.5,775,777,4209459,13.2,0,13.2,52.21396833,730,843.6,55.32570423,-44.67429577,9.170554434,8.446368514,-0.018689275,-29726776,HDFC
186,27-09-2013,784.2,797,777.3,797,2141757,-8.65,8.65,0,48.47389073,765,843.6,24.42748092,-75.57251908,8.045476711,8.366190153,-0.036905127,-31868533,HDFC
187,30-09-2013,764.25,780,755.7,780,3024909,-19.95,19.95,0,40.71314788,755.7,843.6,9.726962457,-90.27303754,5.480866992,7.789125521,-0.04938118,-34893442,HDFC
188,01-10-2013,785.9,789.5,761.25,763.8,1873462,21.65,0,21.65,50.61380249,755.7,843.6,34.35722412,-65.64277588,5.136162122,7.258532841,-0.016641642,-33019980,HDFC
189,03-10-2013,802.4,804.8,780.1,793.5,4233586,16.5,0,16.5,56.93759676,755.7,843.6,53.12855518,-46.87144482,6.12380121,7.031586515,-0.038523755,-28786394,HDFC
190,04-10-2013,798.7,806.4,790.95,800.95,3557152,-3.7,3.7,0,55.11167794,755.7,843.6,48.91922639,-51.08077361,6.53264902,6.931799016,-0.014437315,-32343546,HDFC
191,07-10-2013,797.8,800.15,777.5,793.25,2439267,-0.9,0.9,0,54.62006508,755.7,843.6,47.89533561,-52.10466439,6.706730384,6.88678529,0.027827879,-34782813,HDFC
192,08-10-2013,791.5,817.8,785.3,815.25,3597782,-6.3,6.3,0,50.94924339,755.7,843.6,40.72810011,-59.27189989,6.264124998,6.762253231,0.004123057,-38380595,HDFC
193,09-10-2013,802.2,804.95,779.5,782.55,3937587,10.7,0,10.7,56.65764727,755.7,843.6,52.90102389,-47.09897611,6.699529349,6.749708455,0.028923235,-34443008,HDFC
194,10-10-2013,808.25,812.25,796,798.35,1568067,6.05,0,6.05,59.71621928,755.7,843.2,60.05714286,-39.94285714,7.446931143,6.889152992,0.019423598,-32874941,HDFC
195,11-10-2013,810.5,817,805.3,816.2,2241802,2.25,0,2.25,60.90022959,755.7,817.8,88.24476651,-11.75523349,8.127124163,7.136747227,0.033537363,-30633139,HDFC
196,14-10-2013,803.35,809.9,796.35,809.9,1734510,-7.15,7.15,0,54.97553268,755.7,817.8,76.7310789,-23.2689211,7.997051886,7.308808159,0.051161269,-32367649,HDFC
197,15-10-2013,801.95,811,797.15,805,1709161,-1.4,1.4,0,53.79318723,755.7,817.8,74.47665056,-25.52334944,7.692328022,7.385512131,0.020422446,-34076810,HDFC
198,17-10-2013,795.2,816,790,816,2421727,-6.75,6.75,0,48.04481233,755.7,817.8,63.60708535,-36.39291465,6.827460967,7.273901898,-0.008973081,-36498537,HDFC
199,18-10-2013,819.45,822,799.05,800,2055857,24.25,0,24.25,63.99425434,755.7,822,96.15384615,-3.846153846,8.006525314,7.420426581,0.025979717,-34442680,HDFC
200,21-10-2013,821.15,826.5,804.05,826.5,2714921,1.7,0,1.7,64.86666514,755.7,826.5,92.44350282,-7.556497175,8.974663729,7.731274011,0.029267987,-31727759,HDFC
201,22-10-2013,810.7,820.55,799.2,816.05,2072556,-10.45,10.45,0,55.35378874,761.25,826.5,75.78544061,-24.21455939,8.797283261,7.944475861,0.024257738,-33800315,HDFC
202,23-10-2013,809.7,816.9,798.3,813.25,2014493,-1,1,0,54.47173887,777.5,826.5,65.71428571,-34.28571429,8.478283951,8.051237479,0.009349289,-35814808,HDFC
203,24-10-2013,812.15,820,803.5,807.1,2202103,2.45,0,2.45,56.43421906,777.5,826.5,70.71428571,-29.28571429,8.327178661,8.106425715,0.00482524,-33612705,HDFC
204,25-10-2013,809.8,814,803.7,814,1613485,-2.35,2.35,0,53.86455145,777.5,826.5,65.91836735,-34.08163265,7.926430338,8.07042664,-0.000863664,-35226190,HDFC
205,28-10-2013,820.85,823,811.85,815,1410915,11.05,0,11.05,63.0041946,779.5,826.5,87.9787234,-12.0212766,8.403605415,8.137062395,0.02178378,-33815275,HDFC
206,29-10-2013,839.6,842,812.55,827.8,2433473,18.75,0,18.75,73.34338259,779.5,842,96.16,-3.84,10.17741928,8.545133771,0.046948064,-31381802,HDFC
207,30-10-2013,849.45,852.2,838.85,842,5509041,9.85,0,9.85,77.20490239,790,852.2,95.57877814,-4.421221865,12.23693239,9.283493496,0.068221831,-25872761,HDFC
208,31-10-2013,855.05,859.25,844.05,846,4891246,5.6,0,5.6,79.18309715,790,859.25,93.93501805,-6.064981949,14.15778243,10.25835128,0.043443773,-20981515,HDFC
209,01-11-2013,855.4,859.3,845.1,855.5,3546371,0.35,0,0.35,79.31256507,790,859.3,94.37229437,-5.627705628,15.52929988,11.312541,0.041709797,-17435144,HDFC
210,03-11-2013,852.8,858.65,843.25,856,176489,-2.6,2.6,0,75.29848972,790,859.3,90.62049062,-9.37950938,16.21947112,12.29392703,0.05193043,-17611633,HDFC
211,05-11-2013,859.45,864.9,848.5,848.5,2863157,6.65,0,6.65,78.50850022,790,864.9,92.72363151,-7.276368491,17.10585059,13.25631174,0.06144251,-14748476,HDFC
212,06-11-2013,838.95,857.95,833.05,856.1,3170876,-20.5,20.5,0,53.69074496,798.3,864.9,61.03603604,-38.96396396,15.97004144,13.79905768,0.03299883,-17919352,HDFC
213,07-11-2013,841.75,859,837.95,842,2434715,2.8,0,2.8,55.88835749,798.3,864.9,65.24024024,-34.75975976,15.12152951,14.06355204,0.039454186,-15484637,HDFC
214,08-11-2013,809.35,838.95,805.55,834,3457699,-32.4,32.4,0,34.2116831,798.3,864.9,16.59159159,-83.40840841,11.69980061,13.59080176,-0.014009868,-18942336,HDFC
215,11-11-2013,805.35,814,793.65,809.35,2901036,-4,4,0,32.42044559,793.65,864.9,16.42105263,-83.57894737,8.56653952,12.58594931,-0.040793235,-21843372,HDFC
216,12-11-2013,794.85,813.8,793,808.7,1768595,-10.5,10.5,0,27.98284848,793,864.9,2.573018081,-97.42698192,5.176474156,11.10405428,-0.064276885,-23611967,HDFC
217,13-11-2013,791.4,801.65,788.55,790,2038529,-3.45,3.45,0,26.60237822,788.55,864.9,3.73280943,-96.26719057,2.186235219,9.320490468,-0.074440091,-25650496,HDFC
218,14-11-2013,793.3,812.95,790,800.1,1226278,1.9,0,1.9,28.83334997,788.55,864.9,6.22134905,-93.77865095,-0.02989199,7.450413976,-0.072597615,-24424218,HDFC
219,18-11-2013,814.45,817,796.75,802.25,2930824,21.15,0,21.15,48.81593055,788.55,864.9,33.9227243,-66.0772757,-0.078653923,5.944600396,-0.044969512,-21493394,HDFC
220,19-11-2013,818.4,821.55,811.35,817.1,1295454,3.95,0,3.95,51.73625243,788.55,864.9,39.09626719,-60.90373281,0.199138327,4.795507983,-0.047763104,-20197940,HDFC
221,20-11-2013,807.75,826.1,801,813.5,1844772,-10.65,10.65,0,43.93740031,788.55,864.9,25.14734774,-74.85265226,-0.435060174,3.749394351,-0.037189344,-22042712,HDFC
222,21-11-2013,781.7,803.7,780.1,802,2638821,-26.05,26.05,0,30.82367331,780.1,864.9,1.886792453,-98.11320755,-3.005044001,2.398506681,-0.071339471,-24681533,HDFC
223,22-11-2013,793.35,802.7,780.5,780.5,1420386,11.65,0,11.65,40.05586077,780.1,864.9,15.625,-84.375,-4.054973876,1.10781057,-0.01976895,-23261147,HDFC
224,25-11-2013,818.7,822,797.4,798,1549773,25.35,0,25.35,55.10067616,780.1,864.9,45.51886792,-54.48113208,-2.809135812,0.324421293,0.016576644,-21711374,HDFC
225,26-11-2013,807.35,818,803,811,2081747,-11.35,11.35,0,48.77633739,780.1,859,34.5373891,-65.4626109,-2.706451997,-0.281753365,0.015726238,-23793121,HDFC
226,27-11-2013,808.1,812,795.55,807,2199636,0.75,0,0.75,49.220721,780.1,859,35.48795944,-64.51204056,-2.535329899,-0.732468672,0.021101845,-21593485,HDFC
227,28-11-2013,814.1,818.6,805.6,815,2998078,6,0,6,52.98564155,780.1,838.95,57.7740017,-42.2259983,-1.893734763,-0.96472189,0.026219589,-18595407,HDFC
228,29-11-2013,823.8,827.45,812.25,814.55,3710056,9.7,0,9.7,58.69792266,780.1,827.45,92.29144667,-7.708553326,-0.59569033,-0.890915578,0.01148014,-14885351,HDFC
229,02-12-2013,827.65,832,821,821,1689702,3.85,0,3.85,60.87498315,780.1,832,91.61849711,-8.38150289,0.735207044,-0.565691053,0.011302542,-13195649,HDFC
230,03-12-2013,822.4,826,815,822,2469584,-5.25,5.25,0,56.21288951,780.1,832,81.50289017,-18.49710983,1.350751068,-0.182402629,0.0181368,-15665233,HDFC
231,04-12-2013,812.15,821.35,810.05,820,1755186,-10.25,10.25,0,47.94169895,780.1,832,61.75337187,-38.24662813,0.999957924,0.054069482,0.038953563,-17420419,HDFC
232,05-12-2013,827.45,839,822.65,827,2586531,15.3,0,15.3,58.46712306,780.1,839,80.39049236,-19.60950764,1.934237262,0.430103038,0.04298229,-14833888,HDFC
233,06-12-2013,813.75,829.5,810.05,824.5,2472172,-13.7,13.7,0,48.36413035,780.1,839,57.13073005,-42.86926995,1.55130243,0.654342916,-0.006046171,-17306060,HDFC
234,09-12-2013,820,842.95,818.95,842.2,3450146,6.25,0,6.25,52.66928482,780.1,842.95,63.48448687,-36.51551313,1.732179095,0.869910152,0.015668545,-13855914,HDFC
235,10-12-2013,808.95,820.6,805.75,820,2515867,-11.05,11.05,0,45.01319152,780.1,842.95,45.90294352,-54.09705648,0.972670178,0.890462157,0.00105185,-16371781,HDFC
236,11-12-2013,818.2,824.6,804.4,804.8,2365634,9.25,0,9.25,51.78301313,780.5,842.95,60.36829464,-39.63170536,1.104420503,0.933253826,0.005036236,-14006147,HDFC
237,12-12-2013,826.95,830.55,815.5,815.5,2374414,8.75,0,8.75,57.49483488,795.55,842.95,66.24472574,-33.75527426,1.893063395,1.12521574,0.003823744,-11631733,HDFC
238,13-12-2013,806.8,821.65,803.4,819.5,3540693,-20.15,20.15,0,43.73004932,795.55,842.95,23.73417722,-76.26582278,0.881965238,1.07656564,-0.025191808,-15172426,HDFC
239,16-12-2013,798.55,809.8,795.55,809.8,1868292,-8.25,8.25,0,39.28667686,795.55,842.95,6.329113924,-93.67088608,-0.578376221,0.745577268,-0.029000486,-17040718,HDFC
240,17-12-2013,778.45,803,774.55,800.25,2100476,-20.1,20.1,0,30.5580113,774.55,842.95,5.701754386,-94.29824561,-3.319345997,-0.067407385,-0.041494798,-19141194,HDFC
241,18-12-2013,798.25,808.9,778.45,779.9,2269221,19.8,0,19.8,44.55879278,774.55,842.95,34.64912281,-65.35087719,-3.849514968,-0.823828902,-0.035289141,-16871973,HDFC
242,19-12-2013,776.25,808.95,775,804,2096385,-22,22,0,35.40669059,774.55,842.95,2.485380117,-97.51461988,-5.976006144,-1.85426435,-0.046082949,-18968358,HDFC
243,20-12-2013,801.85,808.35,770.1,770.1,2456400,25.6,0,25.6,49.36929945,770.1,842.95,43.58270419,-56.41729581,-5.531792621,-2.589770004,-0.022134146,-16511958,HDFC
244,23-12-2013,789.8,807.2,787.15,801.85,1772374,-12.05,12.05,0,44.18223434,770.1,842.95,27.04186685,-72.95813315,-6.081975266,-3.288211057,-0.023672662,-18284332,HDFC
245,24-12-2013,779.9,795.05,778.1,793.3,1841042,-9.9,9.9,0,40.18026644,770.1,842.95,13.45229925,-86.54770075,-7.233463371,-4.07726152,-0.046810071,-20125374,HDFC
246,26-12-2013,779.3,786.05,774.1,779,3829349,-0.6,0.6,0,39.92735965,770.1,842.95,12.62868909,-87.37131091,-8.101057033,-4.882020622,-0.05762138,-23954723,HDFC
247,27-12-2013,788.4,791.6,775.25,780.2,1390357,9.1,0,9.1,45.88783168,770.1,842.95,25.12010981,-74.87989019,-7.962549996,-5.498126497,-0.022806148,-22564366,HDFC
248,30-12-2013,795.65,799.4,786.95,791.8,1971385,7.25,0,7.25,50.41091463,770.1,830.55,42.26633581,-57.73366419,-7.184944201,-5.835490038,-0.003631582,-20592981,HDFC
249,31-12-2013,794.65,801.85,790.6,800.25,1330552,-1,1,0,49.74910244,770.1,830.55,40.6120761,-59.3879239,-6.573601264,-5.983112283,0.020810585,-21923533,HDFC
250,01-01-2014,793.5,800.1,790.6,798.25,587564,-1.15,1.15,0,48.89729627,770.1,830.55,38.70967742,-61.29032258,-6.111453934,-6.008780613,-0.005950517,-22511097,HDFC
251,02-01-2014,791.1,809.5,784,791.6,2538179,-2.4,2.4,0,46.9610755,770.1,821.65,40.7371484,-59.2628516,-5.871179485,-5.981260388,0.019130435,-25049276,HDFC
252,03-01-2014,791,794.9,780,791,1855802,-0.1,0.1,0,46.87184389,770.1,809.8,52.64483627,-47.35516373,-5.623999452,-5.909808201,-0.013531209,-26905078,HDFC
253,06-01-2014,795.85,798.4,784.35,790,1861785,4.85,0,4.85,51.97817533,770.1,809.5,65.35532995,-34.64467005,-4.979354135,-5.723717387,0.007660167,-25043293,HDFC
254,07-01-2014,797.9,800.6,788.4,794,2216143,2.05,0,2.05,54.1284205,770.1,809.5,70.55837563,-29.44162437,-4.2540126,-5.42977643,0.023079882,-22827150,HDFC
255,08-01-2014,804.3,805.5,795.35,797.9,2659846,6.4,0,6.4,60.49966311,770.1,809.5,86.80203046,-13.19796954,-3.126704988,-4.969162142,0.032080072,-20167304,HDFC
256,09-01-2014,802.15,806.85,797.4,803.25,2287549,-2.15,2.15,0,57.40889766,770.1,809.5,81.34517766,-18.65482234,-2.379364778,-4.451202669,0.017440386,-22454853,HDFC
257,10-01-2014,801.45,806.25,796.2,796.2,3261578,-0.7,0.7,0,56.32785266,774.1,809.5,77.25988701,-22.74011299,-1.82256701,-3.925475537,0.007289637,-25716431,HDFC
258,13-01-2014,818.65,822,800,803,2639823,17.2,0,17.2,71.52829794,774.1,822,93.00626305,-6.993736952,0.006520322,-3.139076365,0.030201976,-23076608,HDFC
259,14-01-2014,824.35,826.25,817.1,817.1,2018695,5.7,0,5.7,74.87251938,774.1,826.25,96.35666347,-3.643336529,1.8941925,-2.132422592,0.038878387,-21057913,HDFC
260,15-01-2014,846.5,849.8,820.65,824.1,4991438,22.15,0,22.15,83.5408541,775.25,849.8,95.57344064,-4.426559356,5.118503263,-0.682237421,0.070029073,-16066475,HDFC
261,16-01-2014,857.6,866.5,845.3,846,4470573,11.1,0,11.1,86.27801759,780,866.5,89.71098266,-10.28901734,8.471812227,1.148572508,0.084197219,-11595902,HDFC
262,17-01-2014,840.05,861.95,834.25,852,3708927,-17.55,17.55,0,66.19529409,780,866.5,69.42196532,-30.57803468,9.602503728,2.839358752,0.055538104,-15304829,HDFC
263,20-01-2014,834.8,845,829.05,844.4,2884920,-5.25,5.25,0,61.27243211,780,866.5,63.35260116,-36.64739884,9.960139478,4.263514898,0.046246397,-18189749,HDFC
264,21-01-2014,838.15,843.3,832.2,838,4270055,3.35,0,3.35,63.28287887,780,866.5,67.22543353,-32.77456647,10.39406903,5.489625724,0.042086286,-13919694,HDFC
265,22-01-2014,841.05,846.1,830.6,838.15,2824568,2.9,0,2.9,65.09291417,780,866.5,70.57803468,-29.42196532,10.84693043,6.561086665,0.048494671,-11095126,HDFC
266,23-01-2014,856.15,859.45,836.2,836.2,3523391,15.1,0,15.1,73.06911249,784.35,866.5,87.40109556,-12.59890444,12.28268303,7.705405938,0.068251295,-7571735,HDFC
267,24-01-2014,844.7,851.95,843.5,849,3481450,-11.45,11.45,0,60.8949271,788.4,866.5,72.08706786,-27.91293214,12.35419651,8.635164053,0.03182068,-11053185,HDFC
268,27-01-2014,833,842.5,830.95,835,3281902,-11.7,11.7,0,50.89668099,795.35,866.5,52.91637386,-47.08362614,11.3361037,9.175351982,0.010493116,-14335087,HDFC
269,28-01-2014,831.15,845,826.7,832.5,3437311,-1.85,1.85,0,49.41638867,796.2,866.5,49.71550498,-50.28449502,10.26168792,9.39261917,-0.018133491,-17772398,HDFC
270,29-01-2014,825.15,839,820.7,836,3226325,-6,6,0,44.56587342,796.2,866.5,41.18065434,-58.81934566,8.824334385,9.278962213,-0.037838153,-20998723,HDFC
271,30-01-2014,829.15,833.9,810.3,811.25,6127036,4,0,4,48.45756529,800,866.5,43.83458647,-56.16541353,7.916728802,9.006515531,-0.012975418,-14871687,HDFC
272,31-01-2014,808.45,830.45,804.35,828.8,5171853,-20.7,20.7,0,34.14432342,804.35,866.5,6.59694288,-93.40305712,5.464140624,8.298040549,-0.031564447,-20043540,HDFC
273,03-02-2014,788.85,808.65,785.35,802.1,3091470,-19.6,19.6,0,25.8139493,785.35,866.5,4.313000616,-95.68699938,1.916795009,7.021791441,-0.05882002,-23135010,HDFC
274,04-02-2014,788.15,796,778.45,782,2792957,-0.7,0.7,0,25.55700099,778.45,866.5,11.01646792,-88.98353208,-0.940148649,5.429403423,-0.062897569,-25927967,HDFC
275,05-02-2014,784.8,789.65,779,787.9,1773469,-3.35,3.35,0,24.22544991,778.45,861.95,7.604790419,-92.39520958,-3.435017343,3.65651927,-0.0833382,-27701436,HDFC
276,06-02-2014,785.35,796.3,772.35,789.75,2223598,0.55,0,0.55,24.96602937,772.35,859.45,14.92537313,-85.07462687,-5.306666407,1.863882135,-0.070261631,-25477838,HDFC
277,07-02-2014,783.45,793.95,775.3,790.8,2360800,-1.9,1.9,0,24.02989335,772.35,859.45,12.74397245,-87.25602755,-6.864150244,0.118275659,-0.059483794,-27838638,HDFC
278,10-02-2014,765.4,785.65,762.8,783.25,2554784,-18.05,18.05,0,17.0301803,762.8,859.45,2.690118986,-97.30988101,-9.446063218,-1.794592117,-0.079107261,-30393422,HDFC
279,11-02-2014,774.8,777.25,764,764,2415467,9.4,0,9.4,29.38954039,762.8,859.45,12.41593378,-87.58406622,-10.61142452,-3.557958596,-0.061019209,-27977955,HDFC
280,12-02-2014,785.5,786.65,773.9,779,2260055,10.7,0,10.7,40.94386781,762.8,851.95,25.46270331,-74.53729669,-10.5499677,-4.956360418,-0.052644274,-25717900,HDFC
281,13-02-2014,766.05,784.85,763.2,780.25,1859299,-19.45,19.45,0,30.48211483,762.8,845,3.95377129,-96.04622871,-11.93315718,-6.351719769,-0.052446039,-27577199,HDFC
282,14-02-2014,770.7,773.6,755,763.2,3607903,4.65,0,4.65,35.05945096,755,845,17.44444444,-82.55555556,-12.50992207,-7.583360229,-0.023008176,-23969296,HDFC
283,17-02-2014,779.3,788.5,767,767,4922666,8.6,0,8.6,43.06011839,755,839,28.92857143,-71.07142857,-12.13320029,-8.493328242,-0.011228827,-19046630,HDFC
284,18-02-2014,803.9,807.5,779.3,779.3,2435186,24.6,0,24.6,59.5202323,755,833.9,61.97718631,-38.02281369,-9.737384654,-8.742139524,0.024337411,-16611444,HDFC
285,19-02-2014,805.8,808.4,792.75,804.1,1513961,1.9,0,1.9,60.53688824,755,830.45,67.32935719,-32.67064281,-7.597786821,-8.513268983,0.026039346,-15097483,HDFC
286,20-02-2014,791.65,805.1,788.95,799.45,1414959,-14.15,14.15,0,49.79109631,755,808.65,68.31314073,-31.68685927,-6.963654196,-8.203346026,0.010466526,-16512442,HDFC
287,21-02-2014,800.6,803.75,791.05,792.3,928876,8.95,0,8.95,55.54958662,755,808.4,85.39325843,-14.60674157,-5.673508644,-7.69737855,0.045989025,-15583566,HDFC
288,24-02-2014,810.25,813.2,788.55,797,768621,9.65,0,9.65,61.10004874,755,813.2,94.93127148,-5.068728522,-3.828254909,-6.923553821,0.045753743,-14814945,HDFC
289,25-02-2014,811.4,817.65,807.15,815.1,1121054,1.15,0,1.15,61.75668864,755,817.65,90.02394254,-9.976057462,-2.247178564,-5.98827877,0.032972629,-13693891,HDFC
290,26-02-2014,819.1,821.75,810,814,2057241,7.7,0,7.7,66.16870953,755,821.75,96.02996255,-3.970037453,-0.36858965,-4.864340946,0.069251354,-11636650,HDFC
291,28-02-2014,819.3,824.05,810.55,812.25,3326028,0.2,0,0.2,66.28528007,755,824.05,93.12092686,-6.879073135,1.123394139,-3.666793929,0.063059556,-8310622,HDFC
292,03-03-2014,812.55,825.9,808.9,815,1144895,-6.75,6.75,0,58.44328534,755,825.9,81.17066291,-18.82933709,1.741063557,-2.585222432,0.042666496,-9455517,HDFC
293,04-03-2014,821.85,824.6,811,811,1135629,9.3,0,9.3,65.02187832,755,825.9,94.2877292,-5.712270804,2.947031749,-1.478771596,0.022328648,-8319888,HDFC
294,05-03-2014,827.15,828.6,812.6,824,1275795,5.3,0,5.3,68.31966393,755,828.6,98.0298913,-1.970108696,4.281086239,-0.326800029,0.026495408,-7044093,HDFC
295,06-03-2014,837.85,841.9,824.05,830,1724126,10.7,0,10.7,74.02452689,755,841.9,95.33947066,-4.660529344,6.131059572,0.964771891,0.058359123,-5319967,HDFC
296,07-03-2014,848.25,853.9,837.25,837.85,3494157,10.4,0,10.4,78.3889661,767,853.9,93.49827388,-6.501726122,8.340228882,2.43986329,0.059517862,-1825810,HDFC
297,10-03-2014,850.2,858,831.1,841,3766475,1.95,0,1.95,79.14699002,779.3,858,90.08894536,-9.911054638,10.13156975,3.978204582,0.04930577,1940665,HDFC
298,11-03-2014,853.1,856.1,843.65,850.2,3292684,2.9,0,2.9,80.33086007,788.55,858,92.94456443,-7.055435565,11.65092149,5.512747963,0.051392655,5233349,HDFC
299,12-03-2014,854.65,858,845.15,846.25,3043527,1.55,0,1.55,80.99622035,788.55,858,95.17638589,-4.823614111,12.83216947,6.976632265,0.043401294,8276876,HDFC
300,13-03-2014,865.4,868.8,850,858.1,3525842,10.75,0,10.75,85.04469519,788.55,868.8,95.76323988,-4.236760125,14.46896297,8.475098406,0.056267545,11802718,HDFC
301,14-03-2014,856.65,862.8,852.25,855.1,3850399,-8.75,8.75,0,70.86598346,788.55,868.8,84.85981308,-15.14018692,14.88845687,9.757770098,0.054273583,7952319,HDFC
302,18-03-2014,852.2,859.8,841,859.8,3207184,-4.45,4.45,0,64.5507329,807.15,868.8,73.07380373,-26.92619627,14.6924654,10.74470916,0.03692888,4745135,HDFC
303,19-03-2014,867.7,869.1,854.95,856,2125150,15.5,0,15.5,73.89897457,808.9,869.1,97.6744186,-2.325581395,15.60794257,11.71735584,0.049023756,6870285,HDFC
304,20-03-2014,847.85,868,845.6,868,1959880,-19.85,19.85,0,53.1772717,808.9,869.1,64.70099668,-35.29900332,14.56385269,12.28665521,0.011935311,4910405,HDFC
305,21-03-2014,843.25,857.45,839,852.25,4354231,-4.6,4.6,0,49.46825453,808.9,869.1,57.05980066,-42.94019934,13.21291215,12.4719066,-0.005894489,556174,HDFC
306,22-03-2014,841.9,847,840.7,845.5,82662,-1.35,1.35,0,48.3268358,811,869.1,53.18416523,-46.81583477,11.89621615,12.35676851,-0.009762409,473512,HDFC
307,24-03-2014,860.25,863.7,841,845.1,3077297,18.35,0,18.35,62.05756995,812.6,869.1,84.33628319,-15.66371681,12.19286496,12.3239878,0.008381198,3550809,HDFC
308,25-03-2014,871.7,874.5,856.2,856.2,2470681,11.45,0,11.45,68.15076443,824.05,874.5,94.44995045,-5.550049554,13.19972241,12.49913472,0.019949687,6021490,HDFC
309,26-03-2014,866.4,874.7,861.1,873,2320464,-5.3,5.3,0,62.76718826,831.1,874.7,80.96330275,-19.03669725,13.41535463,12.6823787,0.001155535,3701026,HDFC
310,27-03-2014,875.1,880,860.9,870.5,4636590,8.7,0,8.7,67.61295733,831.1,880,89.9795501,-10.0204499,14.12543281,12.97098953,0.021537384,8337616,HDFC
311,28-03-2014,875.8,880,856.05,880,2485454,0.7,0,0.7,67.99960809,839,880,89.75609756,-10.24390244,14.57662874,13.29211737,0.02769303,10823070,HDFC
312,31-03-2014,883.9,887,873.2,880.9,2082316,8.1,0,8.1,72.39912781,839,887,93.54166667,-6.458333333,15.41016823,13.71572754,0.018670047,12905386,HDFC
313,01-04-2014,888.8,894.8,870.4,885,2802631,4.9,0,4.9,74.81589828,839,894.8,89.24731183,-10.75268817,16.27849498,14.22828103,0.048298638,15708017,HDFC
314,02-04-2014,899,905.35,888.4,889.8,3619290,10.2,0,10.2,79.19206267,839,905.35,90.42954032,-9.570459683,17.58697326,14.90001948,0.066113252,19327307,HDFC
315,03-04-2014,904.15,908.1,892.15,899.1,2801434,5.15,0,5.15,81.10487313,839,908.1,94.28364689,-5.716353111,18.82253917,15.68452342,0.073939898,22128741,HDFC
316,04-04-2014,895.1,903,892.7,902,3581987,-9.05,9.05,0,68.36250536,839,908.1,81.18668596,-18.81331404,18.85413595,16.31844592,0.040511479,18546754,HDFC
317,07-04-2014,895.85,900.9,880.8,895.1,4525721,0.75,0,0.75,68.8307684,839,908.1,82.27206946,-17.72793054,18.72385837,16.79952841,0.027704485,23072475,HDFC
318,09-04-2014,922.7,929.7,896,902.25,4159510,26.85,0,26.85,80.65693534,839,929.7,92.28224917,-7.717750827,20.55029208,17.54968114,0.064981533,27231985,HDFC
319,10-04-2014,927.25,934.4,916.2,925,2445503,4.55,0,4.55,81.99284768,840.7,934.4,92.36926361,-7.630736393,22.11003026,18.46175097,0.059593189,29677488,HDFC
320,11-04-2014,918.65,925.8,899.55,920,3477880,-8.6,8.6,0,71.25960284,841,934.4,83.13704497,-16.86295503,22.39404131,19.24820903,0.048926696,26199608,HDFC
321,15-04-2014,887.5,918.65,881.2,915.5,3284203,-31.15,31.15,0,46.06026965,856.05,934.4,40.14039566,-59.85960434,19.87645405,19.37385804,0.004072859,22915405,HDFC
322,16-04-2014,870.2,886.15,866.05,883.35,4295418,-17.3,17.3,0,37.55082699,856.05,934.4,18.05998724,-81.94001276,16.29741613,18.75856966,-0.020927093,18619987,HDFC
323,17-04-2014,879.8,881.95,865,873,2862754,9.6,0,9.6,44.156544,856.05,934.4,30.31269943,-69.68730057,14.07341302,17.82153833,-0.021357063,21482741,HDFC
324,21-04-2014,876.95,882.15,870,877.05,1625072,-2.85,2.85,0,42.61252693,856.05,934.4,26.67517549,-73.32482451,11.94322923,16.64587651,-0.030083504,19857669,HDFC
325,22-04-2014,874.85,886.9,870.3,877.1,1475886,-2.1,2.1,0,41.38227591,865,934.4,14.19308357,-85.80691643,9.970655276,15.31083226,-0.022623171,18381783,HDFC
326,23-04-2014,879.55,882.5,862.1,872,4983550,4.7,0,4.7,45.44935663,862.1,934.4,24.13554633,-75.86445367,8.686494425,13.98596469,-0.01819501,23365333,HDFC
327,25-04-2014,894.1,897,883.5,885,5096356,14.55,0,14.55,56.28385363,862.1,934.4,44.26002766,-55.73997234,8.742077868,12.93718733,-0.03099599,28461689,HDFC
328,28-04-2014,884.35,892.95,880,887.3,2581562,-9.75,9.75,0,48.79113646,862.1,934.4,30.77455048,-69.22544952,7.908223553,11.93139457,-0.04626584,25880127,HDFC
329,29-04-2014,887.4,893.4,877,881.15,1794252,3.05,0,3.05,51.13893884,862.1,934.4,34.99308437,-65.00691563,7.408101527,11.02673596,-0.034017308,27674379,HDFC
330,30-04-2014,897.95,903.5,888.45,889.95,2754178,10.55,0,10.55,58.6968253,862.1,934.4,49.58506224,-50.41493776,7.773440664,10.3760769,0.011774648,30428557,HDFC
331,02-05-2014,910.95,914.75,897,897.9,3080739,13,0,13,66.14288082,862.1,934.4,67.56569848,-32.43430152,9.008125848,10.10248669,0.046828315,33509296,HDFC
332,05-05-2014,886.45,912.15,883.15,910,2261063,-24.5,24.5,0,47.5155929,862.1,934.4,33.6791148,-66.3208852,7.918399132,9.665669181,0.007558536,31248233,HDFC
333,06-05-2014,877.55,895.2,873.9,892,2190690,-8.9,8.9,0,42.49891526,862.1,925.8,24.25431711,-75.74568289,6.264414962,8.985418337,0.00068419,29057543,HDFC
334,07-05-2014,852.6,882.9,850.1,881,3008306,-24.95,24.95,0,31.6798153,850.1,918.65,3.646973012,-96.35302699,2.906855684,7.769705806,-0.025432931,26049237,HDFC
335,08-05-2014,850.45,859,840.55,858.95,3293099,-2.15,2.15,0,30.89772727,840.55,914.75,13.34231806,-86.65768194,0.071652766,6.230095198,-0.0330851,22756138,HDFC
336,09-05-2014,884.6,888,851.3,854,1817788,34.15,0,34.15,52.42373523,840.55,914.75,59.36657682,-40.63342318,0.573739907,5.09882414,-0.01062521,24573926,HDFC
337,12-05-2014,895.55,912.9,882.35,882.35,3127891,10.95,0,10.95,57.34028493,840.55,914.75,74.12398922,-25.87601078,1.83407895,4.445875102,0.012664669,27701817,HDFC
338,13-05-2014,906.35,915,899.2,906,3641613,10.8,0,10.8,61.82936192,840.55,915,88.38146407,-11.61853593,3.662161346,4.289132351,0.021354519,31343430,HDFC
339,14-05-2014,888.85,915,883.55,910,3586483,-17.5,17.5,0,51.66465547,840.55,915,64.87575554,-35.12424446,3.656674206,4.162640722,-0.010134195,27756947,HDFC
340,15-05-2014,903.15,908.25,875.35,886,3532044,14.3,0,14.3,58.15140144,840.55,915,84.08327737,-15.91672263,4.751444403,4.280401458,-0.00856249,31288991,HDFC
341,16-05-2014,885.8,956.45,877,920,10749759,-17.35,17.35,0,48.95406308,840.55,956.45,39.04227783,-60.95772217,4.170977243,4.258516615,-0.000733262,20539232,HDFC
342,19-05-2014,916.95,931.5,900.25,900.25,6677460,31.15,0,31.15,61.55162379,840.55,956.45,65.9188956,-34.0811044,6.153563061,4.637525904,0.044897727,27216692,HDFC
343,20-05-2014,940.6,944.4,914.65,921.5,5681528,23.65,0,23.65,68.38634741,840.55,956.45,86.3244176,-13.6755824,9.52335465,5.614691653,0.103213699,32898220,HDFC
344,21-05-2014,940.75,946,933,940,3680783,0.15,0,0.15,68.42742085,840.55,956.45,86.45383952,-13.54616048,12.06694231,6.905141784,0.106179082,36579003,HDFC
345,22-05-2014,920.15,944.6,918,941,3194236,-20.6,20.6,0,56.74488889,840.55,956.45,68.67989646,-31.32010354,12.27896179,7.979905785,0.040187655,33384767,HDFC
346,23-05-2014,931.95,938.75,918.45,926,3675254,11.8,0,11.8,61.13093864,840.55,956.45,78.86108714,-21.13891286,13.24645327,9.033215281,0.040645413,37060021,HDFC
347,26-05-2014,927.75,944.4,914.05,929.3,5260500,-4.2,4.2,0,58.68698421,840.55,956.45,75.23727351,-24.76272649,13.51845994,9.930264214,0.023611188,31799521,HDFC
348,27-05-2014,910.25,934,908,934,4937760,-17.5,17.5,0,49.22550782,840.55,956.45,60.13805004,-39.86194996,12.18150267,10.38051191,0.024076053,26861761,HDFC
349,28-05-2014,902.05,918,892,912,4571686,-8.2,8.2,0,45.27879365,851.3,956.45,48.26438421,-51.73561579,10.34107742,10.37262501,-0.001217959,22290075,HDFC
350,29-05-2014,896.9,914.9,891,900.1,4963006,-5.15,5.15,0,42.79248922,875.35,956.45,26.57213317,-73.42786683,8.370475566,9.972195121,0.012531045,17327069,HDFC
351,30-05-2014,876.8,899,810,899,7232450,-20.1,20.1,0,34.30853424,810,956.45,45.61283715,-54.38716285,5.127747893,9.003305675,-0.043786466,10094619,HDFC
352,02-06-2014,896.35,905.5,871,875,1865891,19.55,0,19.55,46.2646362,810,956.45,58.96210311,-41.03789689,4.088257575,8.020296055,-0.04704444,11960510,HDFC
353,03-06-2014,912.75,918.3,895,898,3408485,16.4,0,16.4,54.31316848,810,956.45,70.16046432,-29.83953568,4.535514362,7.323339717,-0.029763487,15368995,HDFC
354,04-06-2014,901.55,924.5,899.2,918,3371889,-11.2,11.2,0,48.57951133,810,956.45,62.512803,-37.487197,3.940795157,6.646830805,-0.020214096,11997106,HDFC
355,05-06-2014,908.75,918.6,891,900,5395580,7.2,0,7.2,52.31359101,810,946,72.61029412,-27.38970588,4.004296689,6.118323981,-0.024894039,17392686,HDFC
356,06-06-2014,935.15,938.7,907,912.9,4653867,26.4,0,26.4,63.5210873,810,946,92.02205882,-7.977941176,6.114398497,6.117538885,0.007976287,22046553,HDFC
357,09-06-2014,944.95,947.7,934.35,940,3580516,9.8,0,9.8,66.85742699,810,947.7,98.00290487,-1.997095134,8.479698792,6.589970866,0.038121395,25627069,HDFC
358,10-06-2014,954.45,962,930.4,940.35,4912736,9.5,0,9.5,69.9332433,810,962,95.03289474,-4.967105263,10.99405431,7.470787554,0.058089906,30539805,HDFC
359,11-06-2014,956.9,959.95,931.9,951.35,5079938,2.45,0,2.45,70.74125972,810,962,96.64473684,-3.355263158,13.03414419,8.583458882,0.06689709,35619743,HDFC
360,12-06-2014,982.05,985,951.2,952,4444543,25.15,0,25.15,77.80591108,810,985,98.31428571,-1.685714286,16.49023576,10.16481426,0.120038777,40064286,HDFC
361,13-06-2014,979.7,984.7,972.35,980,3800033,-2.35,2.35,0,75.83183248,810,985,96.97142857,-3.028571429,18.82261251,11.89637391,0.09298823,36264253,HDFC
362,16-06-2014,961.65,983.55,956,975,4451944,-18.05,18.05,0,61.91069353,810,985,86.65714286,-13.34285714,18.99558447,13.31621602,0.053574363,31812309,HDFC
363,17-06-2014,965.6,971.95,941.25,957.25,3822167,3.95,0,3.95,63.59808275,810,985,88.91428571,-11.08571429,19.22972962,14.49891874,0.071044313,35634476,HDFC
364,18-06-2014,958.45,972,952.1,965,3381229,-7.15,7.15,0,58.21190285,810,985,84.82857143,-15.17142857,18.62366409,15.32386781,0.054690509,32253247,HDFC
365,19-06-2014,968.45,971,955.5,959.55,2781318,10,0,10,63.23644198,871,985,85.48245614,-14.51754386,18.73431174,16.0059566,0.035609261,35034565,HDFC
366,20-06-2014,969.05,977.4,964.5,969.85,2451177,0.6,0,0.6,63.53994299,891,985,83.03191489,-16.96808511,18.6553683,16.53583894,0.025503995,37485742,HDFC
367,23-06-2014,971,978.2,960.55,974.4,2587975,1.95,0,1.95,64.63478187,891,985,85.10638298,-14.89361702,18.5364768,16.93596651,0.017339829,40073717,HDFC
368,24-06-2014,996.1,1000,972,972.7,3436833,25.1,0,25.1,75.54246594,891,1000,96.42201835,-3.577981651,20.23436549,17.59564631,0.040965618,43510550,HDFC
369,25-06-2014,995.45,1003.4,989.25,998.9,3759548,-0.65,0.65,0,74.85262214,907,1003.4,91.75311203,-8.246887967,21.28217725,18.3329525,0.013644926,39751002,HDFC
370,26-06-2014,976.85,1002.45,970.45,1000,4804273,-18.6,18.6,0,57.5119723,930.4,1003.4,63.63013699,-36.36986301,20.37681977,18.74172595,-0.002909054,34946729,HDFC
371,27-06-2014,976.1,998.9,971.25,980,3307009,-0.75,0.75,0,56.89869501,930.4,1003.4,62.60273973,-37.39726027,19.37545058,18.86847088,0.015026257,31639720,HDFC
372,30-06-2014,992.55,999,975.2,983.7,3290425,16.45,0,16.45,66.05843306,931.9,1003.4,84.82517483,-15.17482517,19.68234993,19.03124669,0.027910108,34930145,HDFC
373,01-07-2014,984.1,998.5,980,990.25,1511271,-8.45,8.45,0,58.66856305,941.25,1003.4,68.94609815,-31.05390185,19.02442377,19.0298821,0.026761959,33418874,HDFC
374,02-07-2014,1007.8,1011.35,989,991.05,1927692,23.7,0,23.7,69.65459789,941.25,1011.35,94.93580599,-5.064194009,20.18275031,19.26045574,0.040631938,35346566,HDFC
375,03-07-2014,1008.15,1017.15,1002,1007.8,1757141,0.35,0,0.35,69.79142066,941.25,1017.15,88.14229249,-11.85770751,20.88818847,19.58600229,0.040348795,37103707,HDFC
376,04-07-2014,1013.1,1016.65,994.1,999.7,1370680,4.95,0,4.95,71.86178635,941.25,1017.15,94.66403162,-5.335968379,21.59771195,19.98834422,0.043357364,38474387,HDFC
377,07-07-2014,1020.6,1024.4,1003.3,1013,2756178,7.5,0,7.5,74.87250347,952.1,1024.4,94.74412172,-5.255878285,22.50576924,20.49182922,0.024595924,41230565,HDFC
378,08-07-2014,1022.2,1046.5,1016.6,1017.2,3414343,1.6,0,1.6,75.51732412,955.5,1046.5,73.2967033,-26.7032967,23.08836946,21.01113727,0.026872269,44644908,HDFC
379,09-07-2014,1015.4,1030.6,1006,1020,2427544,-6.8,6.8,0,67.07629118,960.55,1046.5,63.81617219,-36.18382781,22.73925716,21.35676125,0.039463582,42217364,HDFC
380,10-07-2014,1022.85,1044.7,1002.7,1013,2460496,7.45,0,7.45,71.15246732,960.55,1046.5,72.48400233,-27.51599767,22.80090129,21.64558926,0.047894683,44677860,HDFC
381,11-07-2014,989.65,1018,981,1015,2177647,-33.2,33.2,0,43.47550026,970.45,1046.5,25.24654832,-74.75345168,19.94092559,21.30465652,-0.002921767,42500213,HDFC
382,14-07-2014,983.8,1011.95,980.1,988.2,2076833,-5.85,5.85,0,40.28922607,970.45,1046.5,17.55424063,-82.44575937,17.00629021,20.44498326,-0.000304847,40423380,HDFC
383,15-07-2014,977.55,992.2,968.9,987.1,1496337,-6.25,6.25,0,36.95085147,968.9,1046.5,11.14690722,-88.85309278,14.01469508,19.15892562,-0.030015876,38927043,HDFC
384,16-07-2014,976,984.8,946.05,983,5803707,-1.55,1.55,0,36.09501083,946.05,1046.5,29.81582877,-70.18417123,11.38749439,17.60463938,-0.031890096,33123336,HDFC
385,17-07-2014,972.35,985.2,968.65,974,1224610,-3.65,3.65,0,33.95794024,946.05,1046.5,26.18218019,-73.81781981,8.908206166,15.86535273,-0.040223078,31898726,HDFC
386,18-07-2014,983,987.95,967.7,972.8,1728285,10.65,0,10.65,44.93428257,946.05,1046.5,36.78446989,-63.21553011,7.713798513,14.23504189,-0.036841074,33627011,HDFC
387,21-07-2014,1010.3,1015.7,986,986,2967232,27.3,0,27.3,63.08239605,946.05,1046.5,63.96217023,-36.03782977,8.867880284,13.16160957,-0.011641557,36594243,HDFC
388,22-07-2014,1041.05,1044.7,1007.65,1018.5,2794266,30.75,0,30.75,74.15334611,946.05,1046.5,94.57441513,-5.425584868,12.12400839,12.95408933,0.025260981,39388509,HDFC
389,23-07-2014,1037.05,1045.85,1030.05,1040,2286827,-4,4,0,70.95942453,946.05,1046.5,90.59233449,-9.407665505,14.21785225,13.20684192,0.013882779,37101682,HDFC
390,24-07-2014,1036.25,1040.25,1023.5,1033.9,2219821,-0.8,0.8,0,70.26105376,946.05,1046.5,89.79591837,-10.20408163,15.63248374,13.69197028,0.047087354,34881861,HDFC
391,25-07-2014,1067.75,1079.7,1040,1045,4052214,31.5,0,31.5,79.44986199,946.05,1079.7,91.0587355,-8.941264497,19.07548581,14.76867339,0.085332385,38934075,HDFC
392,28-07-2014,1066.5,1073.85,1046.7,1065.1,1735137,-1.25,1.25,0,78.34152205,946.05,1079.7,90.12345679,-9.87654321,21.455895,16.10611771,0.090992788,37198938,HDFC
393,30-07-2014,1087.55,1092.3,1055.55,1066.15,3614271,21.05,0,21.05,82.96033924,946.05,1092.3,96.75213675,-3.247863248,24.75557861,17.83600989,0.114293033,40813209,HDFC
394,31-07-2014,1068.4,1085,1061.6,1083.1,3912617,-19.15,19.15,0,67.78606727,946.05,1092.3,83.65811966,-16.34188034,25.53105062,19.37501804,0.098781303,36900592,HDFC
395,01-08-2014,1039.65,1059,1035.2,1059,3191220,-28.75,28.75,0,51.47590413,946.05,1092.3,64,-36,23.55421473,20.21085738,0.057629705,33709372,HDFC
396,04-08-2014,1027.2,1048.2,1016.15,1040.15,3447488,-12.45,12.45,0,45.9513691,946.05,1092.3,55.48717949,-44.51282051,20.74382519,20.31745094,0.016727705,30261884,HDFC
397,05-08-2014,1045.45,1054.7,1010,1027.2,2507633,18.25,0,18.25,54.25514189,946.05,1092.3,67.96581197,-32.03418803,19.76139663,20.20624008,0.004226502,32769517,HDFC
398,06-08-2014,1035.35,1061,1030.4,1043,2547257,-10.1,10.1,0,49.40791144,967.7,1092.3,54.29373997,-45.70626003,17.96078854,19.75714977,-0.001639265,30222260,HDFC
399,07-08-2014,1026.85,1041.7,1020.7,1025,1772201,-8.5,8.5,0,45.4636765,967.7,1092.3,47.47191011,-52.52808989,15.66731167,18.93918215,-0.00907117,28450059,HDFC
400,08-08-2014,1026.95,1029.8,1016.6,1018.9,1463169,0.1,0,0.1,45.52271166,986,1092.3,38.52304798,-61.47695202,13.69986043,17.89131781,-0.038211192,29913228,HDFC
401,11-08-2014,1063.2,1069.9,1030.15,1032.25,2698375,36.25,0,36.25,62.50117719,1007.65,1092.3,65.62315416,-34.37684584,14.89402416,17.29185908,-0.003094233,32611603,HDFC
402,12-08-2014,1116.4,1121.9,1067.35,1077.7,3812260,53.2,0,53.2,75.45499156,1010,1121.9,95.08489723,-4.91510277,19.9037647,17.8142402,0.026527516,36423863,HDFC
403,13-08-2014,1144.1,1149,1106.5,1121,6426655,27.7,0,27.7,79.67349808,1010,1149,96.47482014,-3.525179856,25.81163817,19.41371979,0.070853613,42850518,HDFC
404,14-08-2014,1124.3,1151.4,1111.5,1151.4,3955619,-19.8,19.8,0,69.78179637,1010,1151.4,80.83451202,-19.16548798,28.56667706,21.24431125,0.081421632,38894899,HDFC
405,18-08-2014,1112.55,1125.55,1107.55,1119.9,1827672,-11.75,11.75,0,64.31433768,1010,1151.4,72.52475248,-27.47524752,29.4623152,22.88791204,0.083089953,37067227,HDFC
406,19-08-2014,1085.05,1124,1082.4,1117,3108921,-27.5,27.5,0,53.08278497,1010,1151.4,53.07637907,-46.92362093,27.63454092,23.83723782,0.037878426,33958306,HDFC
407,20-08-2014,1072.4,1094,1064.55,1094,2958191,-12.65,12.65,0,48.57986679,1010,1151.4,44.1301273,-55.8698727,24.87848369,24.04548699,0.035785,31000115,HDFC
408,21-08-2014,1064.4,1080,1060.65,1078,3515263,-8,8,0,45.74807973,1010,1151.4,38.47241867,-61.52758133,21.79748746,23.59588708,0.036568145,27484852,HDFC
409,22-08-2014,1044.6,1076.5,1042.15,1065.1,3614598,-19.8,19.8,0,39.21936179,1010,1151.4,24.46958982,-75.53041018,17.55570993,22.38785165,0.017186815,23870254,HDFC
410,25-08-2014,1056.3,1064.4,1045.8,1046,1443151,11.7,0,11.7,44.60903627,1010,1151.4,32.74398868,-67.25601132,14.96564823,20.90341097,-0.006489842,25313405,HDFC
411,26-08-2014,1061.95,1069.8,1054,1056,2604117,5.65,0,5.65,47.2170017,1016.6,1151.4,33.64243323,-66.35756677,13.21656115,19.36604101,-0.048772841,27917522,HDFC
412,27-08-2014,1069.65,1075.7,1057.4,1061.5,3233230,7.7,0,7.7,50.85554553,1016.6,1151.4,39.35459941,-60.64540059,12.30982272,17.95479735,-0.065072983,31150752,HDFC
413,28-08-2014,1074.5,1079.9,1063.9,1068.5,3638090,4.85,0,4.85,53.20018777,1016.6,1151.4,42.95252226,-57.04747774,11.84602683,16.73304324,-0.044294228,34788842,HDFC
414,01-09-2014,1058.7,1084.1,1057,1084.1,2199257,-15.8,15.8,0,45.11032306,1030.15,1151.4,23.54639175,-76.45360825,10.08725765,15.40388613,-0.048402319,32589585,HDFC
415,02-09-2014,1066.25,1080,1059,1059,2506164,7.55,0,7.55,49.35642323,1042.15,1151.4,22.05949657,-77.94050343,9.1966293,14.16243476,-0.01732639,35095749,HDFC
416,03-09-2014,1062.7,1074.85,1057.1,1069.85,2505310,-3.55,3.55,0,47.368417,1042.15,1151.4,18.81006865,-81.18993135,8.110847776,12.95211736,-0.009045132,32590439,HDFC
417,04-09-2014,1080.2,1081.7,1057.7,1066,2384438,17.5,0,17.5,57.17888334,1042.15,1151.4,34.82837529,-65.17162471,8.563744329,12.07444276,0.014844044,34974877,HDFC
418,05-09-2014,1055.05,1081.4,1049.5,1080.05,3252019,-25.15,25.15,0,43.67819885,1042.15,1125.55,15.4676259,-84.5323741,6.814717476,11.0224977,0.010003829,31722858,HDFC
419,08-09-2014,1051.65,1065.9,1046.6,1064.7,2229615,-3.4,3.4,0,42.12664854,1042.15,1124,11.60659743,-88.39340257,5.095511623,9.837100485,-0.004402158,29493243,HDFC
420,09-09-2014,1050.25,1057.35,1045.1,1054.9,1725098,-1.4,1.4,0,41.42747239,1042.15,1094,15.6219865,-84.3780135,3.57880605,8.585441598,-0.011017468,27768145,HDFC
421,10-09-2014,1035.05,1053.25,1032.2,1050,2182023,-15.2,15.2,0,34.29657885,1032.2,1084.1,5.49132948,-94.50867052,1.137184236,7.095790126,-0.032347029,25586122,HDFC
422,11-09-2014,1037.85,1049.75,1032.55,1045.45,3049405,2.8,0,2.8,36.61557703,1032.2,1084.1,10.88631985,-89.11368015,-0.565364869,5.563559127,-0.034108888,28635527,HDFC
423,12-09-2014,1050.3,1054.8,1038.45,1041,1810713,12.45,0,12.45,46.33352787,1032.2,1084.1,34.87475915,-65.12524085,-0.899665566,4.270914188,-0.007934259,30446240,HDFC
424,15-09-2014,1034.1,1050,1026.7,1050,1814730,-16.2,16.2,0,37.66372867,1026.7,1084.1,12.89198606,-87.10801394,-2.443637159,2.928003919,-0.030152403,28631510,HDFC
425,16-09-2014,1017.8,1040.7,1012.75,1026.5,2644331,-16.3,16.3,0,30.94198002,1012.75,1084.1,7.077785564,-92.92221444,-4.925738696,1.357255396,-0.04225087,25987179,HDFC
426,17-09-2014,1018.4,1033.8,1013,1019,2922108,0.6,0,0.6,31.46150338,1012.75,1084.1,7.918710582,-92.08128942,-6.76640812,-0.267477307,-0.057211627,28909287,HDFC
427,18-09-2014,1053.05,1056,1010.65,1012.15,3341891,34.65,0,34.65,54.34699425,1010.65,1084.1,57.72634445,-42.27365555,-5.367315411,-1.287444928,-0.001895645,32251178,HDFC
428,19-09-2014,1066.25,1074,1048.65,1053.8,5966478,13.2,0,13.2,60.19000142,1010.65,1081.7,78.25475018,-21.74524982,-3.157002714,-1.661356485,0.013882946,38217656,HDFC
429,22-09-2014,1079.15,1083.05,1054.8,1056.5,1599003,12.9,0,12.9,65.21082396,1010.65,1083.05,94.61325967,-5.386740331,-0.360239174,-1.401133023,0.027517258,39816659,HDFC
430,23-09-2014,1066.15,1084,1060,1076.85,2035289,-13,13,0,56.87069453,1010.65,1084,75.66462168,-24.33537832,0.798025584,-0.961301302,0.030046858,37781370,HDFC
431,24-09-2014,1054.7,1066.25,1041.55,1064.3,2800306,-11.45,11.45,0,50.32911751,1010.65,1084,60.05453306,-39.94546694,0.783013351,-0.612438371,0.016235487,34981064,HDFC
432,25-09-2014,1056.7,1067.25,1046.7,1052.5,3556326,2,0,2,51.45453842,1010.65,1084,62.78118609,-37.21881391,0.92187256,-0.305576185,0.006093497,38537390,HDFC
433,26-09-2014,1038.2,1057.7,1023.25,1046.6,3125255,-18.5,18.5,0,41.43458441,1010.65,1084,37.55964554,-62.44035446,-0.455623758,-0.3355857,0.0039648,35412135,HDFC
434,29-09-2014,1031.15,1046.5,1025,1038.2,1210491,-7.05,7.05,0,38.1665249,1010.65,1084,27.94819359,-72.05180641,-2.092059634,-0.686880486,0.013116526,34201644,HDFC
435,30-09-2014,1055.25,1062.9,1030.2,1031.15,2920034,24.1,0,24.1,52.83854713,1010.65,1084,60.80436264,-39.19563736,-1.427819256,-0.83506824,0.036184211,37121678,HDFC
436,01-10-2014,1050.35,1058,1040,1050,1439615,-4.9,4.9,0,50.05231416,1010.65,1084,54.12406271,-45.87593729,-1.282014752,-0.924457543,-0.002563981,35682063,HDFC
437,07-10-2014,1017.8,1047,1015.15,1045,2317225,-32.55,32.55,0,35.64535503,1010.65,1084,9.747784594,-90.25221541,-3.749751795,-1.489516393,-0.045439625,33364838,HDFC
438,08-10-2014,1014.65,1025.65,1006.85,1016.1,1956573,-3.15,3.15,0,34.53536351,1006.85,1084,10.11017498,-89.88982502,-5.891713846,-2.369955884,-0.059769263,31408265,HDFC
439,09-10-2014,1042.65,1045.15,1020,1025,1252118,28,0,28,50.38239438,1006.85,1084,46.40311082,-53.59688918,-5.26912897,-2.949790501,-0.022041927,32660383,HDFC
440,10-10-2014,1006.4,1040.65,1003.35,1035,1344101,-36.25,36.25,0,37.00210603,1003.35,1084,3.781773094,-96.21822691,-7.613039635,-3.882440328,-0.045795013,31316282,HDFC
441,13-10-2014,1017.8,1023.7,996.95,1002,1076136,11.4,0,11.4,42.53944643,996.95,1084,23.95175187,-76.04824813,-8.453276884,-4.796607639,-0.036812719,32392418,HDFC
442,14-10-2014,1004.05,1026.2,1000.1,1023.2,2043358,-13.75,13.75,0,37.90291169,996.95,1084,8.156232051,-91.84376795,-10.11211488,-5.859709087,-0.032893469,30349060,HDFC
443,16-10-2014,981.3,1008.8,975,1000.95,3547187,-22.75,22.75,0,31.37453019,975,1084,5.779816514,-94.22018349,-13.11135131,-7.310037532,-0.048344082,26801873,HDFC
444,17-10-2014,997.15,1006.1,978.35,983,2915892,15.85,0,15.85,39.72086388,975,1067.25,24.01084011,-75.98915989,-14.04737586,-8.657505197,-0.055058043,29717765,HDFC
445,20-10-2014,1020.1,1034,1007.6,1011,2152613,22.95,0,22.95,49.90075093,975,1067.25,48.88888889,-51.11111111,-12.78987513,-9.483979183,-0.028799924,31870378,HDFC
446,21-10-2014,1021,1026.7,1006.75,1022.85,2074203,0.9,0,0.9,50.28068549,975,1062.9,52.33219568,-47.66780432,-11.58710533,-9.904604413,0.003144036,33944581,HDFC
447,22-10-2014,1030.75,1035.15,1017.3,1027.9,2441333,9.75,0,9.75,54.5857507,975,1062.9,63.42434585,-36.57565415,-9.734939758,-9.870671482,0.015867541,36385914,HDFC
448,23-10-2014,1031.55,1035.35,1027.25,1034.9,108476,0.8,0,0.8,54.95501248,975,1062.9,64.33447099,-35.66552901,-8.109055736,-9.518348333,-0.01064595,36494390,HDFC
449,27-10-2014,1036.75,1066.4,1032.6,1040,2511008,5.2,0,5.2,57.54407075,975,1066.4,67.56017505,-32.43982495,-6.327989272,-8.88027652,0.030156995,39005398,HDFC
450,28-10-2014,1049.65,1054.05,1039.4,1040,2465451,12.9,0,12.9,63.54225061,975,1066.4,81.67396061,-18.32603939,-3.831393161,-7.870499849,0.031292985,41470849,HDFC
451,29-10-2014,1048.6,1057.05,1037.95,1053.5,1995790,-1.05,1.05,0,62.71016772,975,1066.4,80.52516411,-19.47483589,-1.915468651,-6.679493609,0.0443703,39475059,HDFC
452,30-10-2014,1064.7,1069.85,1044.25,1045,2837530,16.1,0,16.1,69.72441438,975,1069.85,94.57037428,-5.429625725,0.891770992,-5.165240689,0.0849893,42312589,HDFC
453,31-10-2014,1105.9,1110,1066,1066.8,3223522,41.2,0,41.2,80.53524067,975,1110,96.96296296,-3.037037037,6.367622326,-2.858668086,0.109060823,45536111,HDFC
454,03-11-2014,1120.5,1125,1096.5,1108.2,2021290,14.6,0,14.6,83.01512905,975,1125,97,-3,11.74992611,0.063050753,0.098421723,47557401,HDFC
455,05-11-2014,1100.55,1126.9,1093.1,1125.75,3718975,-19.95,19.95,0,69.12899668,975,1126.9,82.65306122,-17.34693878,14.2414755,2.898735701,0.07791381,43838426,HDFC
456,07-11-2014,1099.75,1106.3,1086.6,1101,1961000,-0.8,0.8,0,68.59807438,975,1126.9,82.12639895,-17.87360105,15.96743043,5.512474646,0.066941547,41877426,HDFC
457,10-11-2014,1113.7,1117,1095.2,1095.25,1363710,13.95,0,13.95,72.80103418,978.35,1126.9,91.114103,-8.885897004,18.25052981,8.060085679,0.079637439,43241136,HDFC
458,11-11-2014,1127.55,1133.6,1110.5,1111.95,2754901,13.85,0,13.85,76.41697952,1006.75,1133.6,95.23058731,-4.769412692,20.93614295,10.63529713,0.087581384,45996037,HDFC
459,12-11-2014,1142.7,1149.5,1128,1130,1804098,15.15,0,15.15,79.80552153,1006.75,1149.5,95.23642732,-4.76357268,24.01021429,13.31028056,0.088648597,47800135,HDFC
460,13-11-2014,1129.05,1145.75,1120.7,1145,1391689,-13.65,13.65,0,69.43376972,1017.3,1149.5,84.53101362,-15.46898638,25.05616518,15.65945749,0.076721343,46408446,HDFC
461,14-11-2014,1126.85,1134.4,1103.95,1134.4,1276274,-2.2,2.2,0,67.79523267,1027.25,1149.5,81.47239264,-18.52760736,25.41460345,17.61048668,0.058373251,45132172,HDFC
462,17-11-2014,1129.9,1138.2,1100.1,1129.9,2004892,3.05,0,3.05,68.96672174,1032.6,1149.5,83.23353293,-16.76646707,25.64911089,19.21821152,0.021701781,47137064,HDFC
463,18-11-2014,1105.65,1134,1101,1134,2103196,-24.25,24.25,0,51.71017491,1037.95,1149.5,60.69027342,-39.30972658,23.60607129,20.09578348,-0.013253012,45033868,HDFC
464,19-11-2014,1117.2,1123.4,1101.25,1106,2176314,11.55,0,11.55,57.54775819,1037.95,1149.5,71.04437472,-28.95562528,22.65775171,20.60817712,0.015128799,47210182,HDFC
465,20-11-2014,1122.35,1127.85,1103.7,1115.6,1535144,5.15,0,5.15,60.03344993,1044.25,1149.5,74.20427553,-25.79572447,22.0673845,20.9000186,0.020550125,48745326,HDFC
466,21-11-2014,1134.4,1139.4,1119.8,1121.05,1627570,12.05,0,12.05,65.488928,1066,1149.5,81.91616766,-18.08383234,22.31461948,21.18293877,0.018586693,50372896,HDFC
467,24-11-2014,1136.7,1146,1118.65,1131,2473098,2.3,0,2.3,66.49613731,1086.6,1149.5,79.65023847,-20.34976153,22.43750022,21.43385106,0.008114939,52845994,HDFC
468,25-11-2014,1146.45,1156.7,1126.4,1132.3,3807448,9.75,0,9.75,70.68145458,1086.6,1156.7,85.37803138,-14.62196862,23.05585408,21.75825167,0.003281701,56653442,HDFC
469,26-11-2014,1158.45,1162.8,1126.4,1151.4,2217395,12,0,12,75.0989465,1086.6,1162.8,94.29133858,-5.708661417,24.23483953,22.25356924,0.026039591,58870837,HDFC
470,27-11-2014,1152.6,1164.15,1142,1152.5,2374923,-5.85,5.85,0,69.23136955,1095.2,1164.15,83.24873096,-16.75126904,24.41569891,22.68599517,0.022851311,56495914,HDFC
471,28-11-2014,1160.65,1177.8,1153.9,1155,2580558,8.05,0,8.05,72.62710329,1100.1,1177.8,77.92792793,-22.07207207,24.92132152,23.13306044,0.027214798,59076472,HDFC
472,01-12-2014,1137.55,1166.1,1134.35,1161.1,2604026,-23.1,23.1,0,53.19039603,1100.1,1177.8,48.1981982,-51.8018018,23.19072587,23.14459353,0.028851807,56472446,HDFC
473,02-12-2014,1125.1,1137.5,1111.7,1136.1,1735746,-12.45,12.45,0,45.60105394,1100.1,1177.8,32.17503218,-67.82496782,20.57740193,22.63115521,0.00707125,54736700,HDFC
474,03-12-2014,1104.6,1130.95,1099.5,1122.5,2620306,-20.5,20.5,0,35.87573013,1099.5,1177.8,6.513409962,-93.48659004,16.66009796,21.43694376,-0.015815031,52116394,HDFC
475,04-12-2014,1113,1116.65,1090,1110,2063649,8.4,0,8.4,41.74931881,1090,1177.8,26.19589977,-73.80410023,14.07121197,19.9637974,-0.018864598,54180043,HDFC
476,05-12-2014,1114.85,1122.65,1109.7,1120,1693044,1.85,0,1.85,43.07435997,1090,1177.8,28.30296128,-71.69703872,12.03010514,18.37705895,-0.01922231,55873087,HDFC
477,08-12-2014,1107.6,1128.8,1104.35,1120,1440243,-7.25,7.25,0,39.05699431,1090,1177.8,20.04555809,-79.95444191,9.715504579,16.64474807,-0.033887217,54432844,HDFC
478,09-12-2014,1103.2,1119.45,1082.6,1108,2008922,-4.4,4.4,0,36.66253429,1082.6,1177.8,21.63865546,-78.36134454,7.440355938,14.80386965,-0.047693038,52423922,HDFC
479,10-12-2014,1100.05,1112.35,1085.3,1109.25,2357400,-3.15,3.15,0,34.89534895,1082.6,1177.8,18.32983193,-81.67016807,5.321759642,12.90744765,-0.045592573,50066522,HDFC
480,11-12-2014,1092.6,1109.85,1087.6,1102,2835509,-7.45,7.45,0,30.83884959,1082.6,1177.8,10.50420168,-89.49579832,3.006941921,10.9273465,-0.05863094,47231013,HDFC
481,12-12-2014,1069.5,1102.25,1061.75,1088.25,1987564,-23.1,23.1,0,21.78040795,1061.75,1177.8,6.678155967,-93.32184403,-0.683663894,8.605144422,-0.059821546,45243449,HDFC
482,15-12-2014,1124.3,1129.9,1060.1,1061,2542994,54.8,0,54.8,56.64172554,1060.1,1177.8,54.54545455,-45.45454545,0.804136837,7.044942905,-0.000711048,47786443,HDFC
483,16-12-2014,1086.85,1125.7,1082.85,1125.7,2712191,-37.45,37.45,0,41.91222206,1060.1,1177.8,22.72727273,-77.27272727,-1.02683566,5.430587192,-0.016069165,45074252,HDFC
484,17-12-2014,1088.95,1106.3,1080,1088,2799779,2.1,0,2.1,42.87340347,1060.1,1177.8,24.51146984,-75.48853016,-2.282135073,3.888042739,-0.021608266,47874031,HDFC
485,18-12-2014,1098.2,1104.4,1076,1102.5,2026732,9.25,0,9.25,47.3050013,1060.1,1166.1,35.94339623,-64.05660377,-2.501732789,2.610087633,-0.014934745,49900763,HDFC
486,19-12-2014,1114.95,1120,1100,1108.75,2933314,16.75,0,16.75,54.6547833,1060.1,1137.5,70.86563307,-29.13436693,-1.30909017,1.826252073,0.00663597,52834077,HDFC
487,22-12-2014,1146.3,1150.6,1112.7,1120,1917158,31.35,0,31.35,65.15161728,1060.1,1150.6,95.24861878,-4.751381215,2.141089548,1.889219568,0.039068165,54751235,HDFC
488,23-12-2014,1124.35,1165.9,1120.8,1150,2425339,-21.95,21.95,0,54.88703056,1060.1,1165.9,60.72778828,-39.27221172,3.068824773,2.125140609,0.022089905,52325896,HDFC
489,24-12-2014,1099.85,1133.5,1092.2,1127,4491004,-24.5,24.5,0,45.62867967,1060.1,1165.9,37.57088847,-62.42911153,1.80629454,2.061371395,0.006635548,47834892,HDFC
490,26-12-2014,1116.15,1119.9,1097.5,1108.8,1127180,16.3,0,16.3,51.86202445,1060.1,1165.9,52.97731569,-47.02268431,2.096833023,2.068463721,0.043618513,48962072,HDFC
491,29-12-2014,1124.1,1130,1116.25,1118.35,841728,7.95,0,7.95,54.77954314,1060.1,1165.9,60.49149338,-39.50850662,2.934755389,2.241722054,-0.000177888,49803800,HDFC
492,30-12-2014,1129.4,1134.9,1117.2,1120,984892,5.3,0,5.3,56.79386068,1060.1,1165.9,65.50094518,-34.49905482,3.980594789,2.589496601,0.039149837,50788692,HDFC
493,31-12-2014,1135.9,1140.75,1121.2,1135.15,1461808,6.5,0,6.5,59.35584507,1060.1,1165.9,71.64461248,-28.35538752,5.273140247,3.12622533,0.043114927,52250500,HDFC
494,01-01-2015,1124,1131.15,1120.1,1130,401576,-11.9,11.9,0,52.74855874,1060.1,1165.9,60.39697543,-39.60302457,5.276437797,3.556267824,0.023492989,51848924,HDFC
495,02-01-2015,1171.9,1176.95,1125.35,1127.3,2019816,47.9,0,47.9,68.85218495,1060.1,1176.95,95.67821994,-4.32178006,9.039973623,4.653008984,0.051078524,53868740,HDFC
496,05-01-2015,1156.4,1175,1150.4,1168.8,2219458,-15.5,15.5,0,61.07986323,1076,1176.95,79.64338782,-20.35661218,10.64912592,5.852232372,0.008810957,51649282,HDFC
497,06-01-2015,1101.95,1148.6,1096.1,1148.6,2531748,-54.45,54.45,0,41.90558447,1076,1176.95,25.70579495,-74.29420505,7.44491048,6.170767993,-0.019922622,49117534,HDFC
498,07-01-2015,1099.25,1114.15,1095,1097.5,2406880,-2.7,2.7,0,41.16619126,1076,1176.95,23.03120357,-76.96879643,4.634258375,5.86346607,-0.000545529,46710654,HDFC
499,08-01-2015,1123.35,1128.5,1110,1114,1675711,24.1,0,24.1,50.21344577,1092.2,1176.95,36.75516224,-63.24483776,4.301875576,5.551147971,0.006450746,48386365,HDFC
500,09-01-2015,1113.3,1135.95,1103.4,1127,1125756,-10.05,10.05,0,46.75400731,1092.2,1176.95,24.89675516,-75.10324484,3.190728077,5.079063992,-0.009607686,47260609,HDFC
501,12-01-2015,1128.55,1135,1098.4,1114.35,1483952,15.25,0,15.25,52.48544929,1092.2,1176.95,42.89085546,-57.10914454,3.500333563,4.763317906,-0.000752612,48744561,HDFC
502,13-01-2015,1122.2,1137.3,1113.6,1134.4,1460452,-6.35,6.35,0,49.90456217,1092.2,1176.95,35.39823009,-64.60176991,3.196459415,4.449946208,-0.012060921,47284109,HDFC
503,14-01-2015,1120.3,1136.85,1112.6,1128.7,1407126,-1.9,1.9,0,49.07148153,1095,1176.95,30.87248322,-69.12751678,2.77038754,4.114034474,-0.003291815,45876983,HDFC
504,15-01-2015,1202.55,1210.9,1144.7,1145.05,3691695,82.25,0,82.25,72.22831688,1095,1210.9,92.79551337,-7.204486626,8.966252738,5.084478127,0.026154109,49568678,HDFC
505,16-01-2015,1194.55,1209,1191,1207.5,3113114,-8,8,0,68.72150235,1095,1210.9,85.89301122,-14.10698878,13.08020692,6.683623886,0.032990315,46455564,HDFC
506,19-01-2015,1181.7,1204.65,1178.15,1198,964317,-12.85,12.85,0,63.04816269,1095,1210.9,74.80586713,-25.19413287,15.12925699,8.372750506,0.072371705,45491247,HDFC
507,20-01-2015,1251.55,1257.75,1181.05,1185.1,4307951,69.85,0,69.85,75.65425338,1095,1257.75,96.19047619,-3.80952381,22.13430468,11.12506134,0.138549011,49799198,HDFC
508,21-01-2015,1287.2,1297.4,1252.25,1259,4571279,35.65,0,35.65,79.72712533,1095,1297.4,94.96047431,-5.039525692,30.21422176,14.94289342,0.14585837,54370477,HDFC
509,22-01-2015,1279.65,1294.85,1272,1287,2899200,-7.55,7.55,0,76.59587102,1095,1297.4,91.23023715,-8.769762846,35.59804031,19.0739228,0.149420641,51471277,HDFC
510,23-01-2015,1290.1,1340.95,1280.2,1288.7,4046463,10.45,0,10.45,77.97721464,1095,1340.95,79.32506607,-20.67493393,40.24407433,23.30795311,0.143148288,55517740,HDFC
511,27-01-2015,1315.85,1320,1288.55,1303.9,4368011,25.75,0,25.75,81.14180947,1095,1340.95,89.79467371,-10.20532629,45.47963859,27.7422902,0.172562823,59885751,HDFC
512,28-01-2015,1344.6,1361.85,1300.7,1323.95,5446676,28.75,0,28.75,84.08753256,1098.4,1361.85,93.45226798,-6.547732017,51.35673722,32.46517961,0.200214228,65332427,HDFC
513,29-01-2015,1315.55,1343.9,1295.4,1338.15,5914732,-29.05,29.05,0,71.13306379,1098.4,1361.85,82.42550769,-17.57449231,53.0586608,36.58387585,0.093966987,59417695,HDFC
514,30-01-2015,1262.5,1333,1257.75,1328.4,3825989,-53.05,53.05,0,53.70073563,1098.4,1361.85,62.28885937,-37.71114063,49.55551077,39.17820283,0.056883345,55591706,HDFC
515,02-02-2015,1269.3,1284.5,1243.6,1262.5,3229041,6.8,0,6.8,55.32018248,1112.6,1361.85,62.86860582,-37.13139418,46.78859253,40.70028077,0.07413049,58820747,HDFC
516,03-02-2015,1230.15,1272,1225.9,1262.5,2595433,-39.15,39.15,0,44.88958941,1112.6,1361.85,47.16148445,-52.83851555,40.96449884,40.75312438,-0.017098797,56225314,HDFC
517,04-02-2015,1232.45,1252,1221.1,1231.05,3263264,2.3,0,2.3,45.58507385,1144.7,1361.85,40.40985494,-59.59014506,36.11810636,39.82612078,-0.042534183,59488578,HDFC
518,05-02-2015,1246.45,1292,1208.15,1236.9,3349987,14,0,14,50.0154225,1178.15,1361.85,37.18018508,-62.81981492,33.02628198,38.46615302,-0.025944594,62838565,HDFC
519,06-02-2015,1280.55,1289.8,1244.3,1245,2615151,34.1,0,34.1,59.323111,1178.15,1361.85,55.74305934,-44.25694066,32.94777249,37.36247691,-0.007402527,65453716,HDFC
520,09-02-2015,1271.95,1279.25,1245.55,1267,1258970,-8.6,8.6,0,56.27378458,1181.05,1361.85,50.27654867,-49.72345133,31.82474912,36.25493135,-0.033362465,64194746,HDFC
521,10-02-2015,1246.15,1293,1232.3,1254.1,2521026,-25.8,25.8,0,47.77345421,1208.15,1361.85,24.72348731,-75.27651269,28.52409265,34.70876361,-0.073218801,61673720,HDFC
522,11-02-2015,1245.8,1267.7,1242.25,1248.9,1857361,-0.35,0.35,0,47.66076381,1208.15,1361.85,24.49577098,-75.50422902,25.58512712,32.88403631,-0.05301965,59816359,HDFC
523,12-02-2015,1253.25,1260,1240.4,1254.95,2251920,7.45,0,7.45,50.52695438,1208.15,1361.85,29.34287573,-70.65712427,23.5852524,31.02427953,-0.007326733,62068279,HDFC
524,13-02-2015,1268.65,1275,1243.65,1253.9,2844615,15.4,0,15.4,56.24232357,1208.15,1361.85,39.36239427,-60.63760573,22.9781112,29.41504586,-0.000512093,64912894,HDFC
525,16-02-2015,1288,1300,1267,1282.5,2215683,19.35,0,19.35,62.51980752,1208.15,1361.85,51.95185426,-48.04814574,23.78416171,28.28886903,0.047026785,67128577,HDFC
526,18-02-2015,1328.6,1335,1291.75,1295,3780032,40.6,0,40.6,72.18157971,1208.15,1343.9,88.72928177,-11.27071823,27.38338462,28.10777215,0.078015335,70908609,HDFC
527,19-02-2015,1353.45,1357.35,1323.55,1330,3724612,24.85,0,24.85,76.46605783,1208.15,1357.35,97.38605898,-2.613941019,31.87356343,28.8609304,0.085843796,74633221,HDFC
528,20-02-2015,1333.15,1353.45,1325,1350,1991120,-20.3,20.3,0,66.77254975,1208.15,1357.35,83.78016086,-16.21983914,33.40890507,29.77052534,0.0410761,72642101,HDFC
529,23-02-2015,1311.25,1338.7,1306.8,1333.15,2775485,-21.9,21.9,0,57.67189785,1208.15,1357.35,69.10187668,-30.89812332,32.48407127,30.31323452,0.030897441,69866616,HDFC
530,24-02-2015,1310.4,1321.95,1296.75,1311.9,2512512,-0.85,0.85,0,57.32201816,1208.15,1357.35,68.53217158,-31.46782842,31.32149126,30.51488587,0.051558801,67354104,HDFC
531,25-02-2015,1340.55,1349.55,1311,1311,2729990,30.15,0,30.15,65.81102475,1208.15,1357.35,88.73994638,-11.26005362,32.45882611,30.90367392,0.076055547,70084094,HDFC
532,26-02-2015,1345.7,1374.2,1336.2,1348,3132313,5.15,0,5.15,67.10077746,1232.3,1374.2,79.9154334,-20.0845666,33.39082548,31.40110423,0.073768203,73216407,HDFC
533,27-02-2015,1347.4,1368.75,1335.6,1354.9,4151270,1.7,0,1.7,67.56679243,1232.3,1374.2,81.11346018,-18.88653982,33.87611473,31.89610633,0.062073858,77367677,HDFC
534,28-02-2015,1335.15,1380,1310.15,1361.45,2254780,-12.25,12.25,0,60.44763466,1232.3,1380,69.63439404,-30.36560596,32.89306654,32.09549837,0.036607143,75112897,HDFC
535,02-03-2015,1339.95,1370,1319,1342.1,4429084,4.8,0,4.8,62.24613209,1240.4,1380,71.31088825,-28.68911175,32.1309283,32.10258436,0.008542827,79541981,HDFC
536,03-03-2015,1368.05,1373,1341,1341,2482102,28.1,0,28.1,71.11741472,1240.4,1380,91.43982808,-8.56017192,33.40924247,32.36391598,0.010787247,82024083,HDFC
537,04-03-2015,1367.7,1402.3,1355.5,1390,3801103,-0.35,0.35,0,70.87805758,1243.65,1402.3,78.19098645,-21.80901355,34.00211833,32.69155645,0.025916063,78222980,HDFC
538,05-03-2015,1394.8,1402.15,1366.4,1367.7,4689288,27.1,0,27.1,77.61039681,1267,1402.3,94.45676275,-5.543237251,36.24095704,33.40143657,0.063717827,82912268,HDFC
539,09-03-2015,1368.35,1397.5,1351.8,1397.5,3448632,-26.45,26.45,0,61.57867159,1291.75,1402.3,69.28991407,-30.71008593,35.47205909,33.81556107,0.044223138,79463636,HDFC
540,10-03-2015,1312.4,1365.15,1307.15,1365.1,5116630,-55.95,55.95,0,40.93845892,1296.75,1402.3,14.82709616,-85.17290384,30.00215831,33.05288052,-0.020998844,74347006,HDFC
541,11-03-2015,1322.75,1338.5,1310.35,1320.8,3331122,10.35,0,10.35,44.88182288,1296.75,1402.3,24.63287541,-75.36712459,26.20035959,31.68237633,-0.017054321,77678128,HDFC
542,12-03-2015,1332.85,1343.45,1316.35,1332.9,3304209,10.1,0,10.1,48.73576758,1296.75,1402.3,34.20180009,-65.79819991,23.72886078,30.09167322,-0.010798575,80982337,HDFC
543,13-03-2015,1328.05,1368,1322,1351,4002153,-4.8,4.8,0,46.9361275,1296.75,1402.3,29.65419233,-70.34580767,21.13918096,28.30117477,-0.005317755,76980184,HDFC
544,16-03-2015,1305.7,1327,1293.6,1327,3706369,-22.35,22.35,0,39.16595344,1293.6,1402.3,11.13155474,-88.86844526,17.0864212,26.05822406,-0.025560655,73273815,HDFC
545,17-03-2015,1339.45,1347.65,1307.1,1311.9,2149304,33.75,0,33.75,52.78502284,1293.6,1402.3,42.18031279,-57.81968721,16.40877271,24.12833379,-0.020905669,75423119,HDFC
546,18-03-2015,1322.05,1343.65,1315,1340.9,2027482,-17.4,17.4,0,46.58151022,1293.6,1402.3,26.17295308,-73.82704692,14.30282279,22.16323159,-0.033377203,73395637,HDFC
547,19-03-2015,1327.7,1354.6,1317.4,1336,5042473,5.65,0,5.65,48.83446057,1293.6,1402.3,31.37074517,-68.62925483,12.94057914,20.3187011,-0.048107256,78438110,HDFC
548,20-03-2015,1338.45,1343.85,1308,1324,3871319,10.75,0,10.75,53.17044732,1293.6,1402.3,41.26034959,-58.73965041,12.5833731,18.7716355,-0.021851135,82309429,HDFC
549,23-03-2015,1345.7,1348.9,1327.5,1332.2,1772832,7.25,0,7.25,56.06760866,1293.6,1402.3,47.9300828,-52.0699172,12.73845813,17.56500002,0.025373362,84082261,HDFC
550,24-03-2015,1358.85,1386.75,1337.25,1337.55,4545753,13.15,0,13.15,61.10373099,1293.6,1402.3,60.0275989,-39.9724011,13.76379873,16.80475977,0.027291627,88628014,HDFC
551,25-03-2015,1354.55,1380.95,1342.2,1362,3628829,-4.3,4.3,0,58.57046547,1293.6,1402.15,56.14923998,-43.85076002,14.06725592,16.257259,0.016280902,84999185,HDFC
552,26-03-2015,1283.7,1339.3,1273,1339.3,6239936,-70.85,70.85,0,32.75400497,1273,1397.5,8.59437751,-91.40562249,8.492844809,14.70437616,-0.033394827,78759249,HDFC
553,27-03-2015,1262.7,1299,1257.45,1290.65,3115046,-21,21,0,28.4632831,1257.45,1386.75,4.060324826,-95.93967517,2.353430468,12.23418702,-0.032932527,75644203,HDFC
554,30-03-2015,1306.2,1308.9,1271.15,1274.9,2242522,43.5,0,43.5,45.5207621,1257.45,1386.75,37.70301624,-62.29698376,0.986613756,9.984672368,-0.024823622,77886725,HDFC
555,31-03-2015,1315.7,1322.95,1297.75,1314,2877703,9.5,0,9.5,48.60862717,1257.45,1386.75,45.05027069,-54.94972931,0.662337259,8.120205346,-0.004803147,80764428,HDFC
556,01-04-2015,1337.05,1341.9,1305.5,1318.95,1492126,21.35,0,21.35,55.19406979,1257.45,1386.75,61.56225831,-38.43774169,2.103860376,6.916936352,0.007042254,82256554,HDFC
557,06-04-2015,1330.6,1354.15,1303.3,1354.15,2076100,-6.45,6.45,0,52.83403569,1257.45,1386.75,56.57385924,-43.42614076,2.694753298,6.072499741,-0.005864993,80180454,HDFC
558,07-04-2015,1328.7,1341.75,1312.55,1332.65,1946193,-1.9,1.9,0,52.07717651,1257.45,1386.75,55.10440835,-44.89559165,2.975427203,5.453085233,-0.01263283,78234261,HDFC
559,08-04-2015,1299.7,1335.3,1297.1,1330.25,2589418,-29,29,0,41.58568062,1257.45,1386.75,32.67594741,-67.32405259,0.848030094,4.532074206,-0.043529455,75644843,HDFC
560,09-04-2015,1303.05,1316.55,1286.5,1309.9,3333998,3.35,0,3.35,43.11323246,1257.45,1386.75,35.26682135,-64.73317865,-0.561161716,3.513427021,-0.038020007,78978841,HDFC
561,10-04-2015,1290.35,1308.65,1282.95,1304.7,2003341,-12.7,12.7,0,38.68778377,1257.45,1386.75,25.44470224,-74.55529776,-2.671939781,2.276353661,0.005180338,76975500,HDFC
562,13-04-2015,1305.25,1312,1291.2,1299.9,2030711,14.9,0,14.9,46.16805355,1257.45,1386.75,36.9682908,-63.0317092,-3.106629834,1.199756962,0.033697632,79006211,HDFC
563,15-04-2015,1290.45,1313.5,1279.6,1313,2830551,-14.8,14.8,0,40.50441002,1257.45,1386.75,25.52204176,-74.47795824,-4.592422556,0.041321058,-0.012057878,76175660,HDFC
564,16-04-2015,1306.8,1310,1281.1,1294.8,3456440,16.35,0,16.35,48.54977215,1257.45,1380.95,39.95951417,-60.04048583,-4.399896369,-0.846922427,-0.00676446,79632100,HDFC
565,17-04-2015,1306.7,1315.95,1297.2,1306.7,2204849,-0.1,0.1,0,48.50348463,1257.45,1354.15,50.93071355,-49.06928645,-4.206892702,-1.518916482,-0.022699226,77427251,HDFC
566,20-04-2015,1268.65,1305.75,1256.2,1295,2966624,-38.05,38.05,0,34.19155631,1256.2,1354.15,12.71056662,-87.28943338,-7.043064842,-2.623746154,-0.046557944,74460627,HDFC
567,21-04-2015,1258.15,1276.8,1243.3,1266.65,2954400,-10.5,10.5,0,31.25506844,1243.3,1354.15,13.39648173,-86.60351827,-10.02248102,-4.103493127,-0.053097012,71506227,HDFC
568,22-04-2015,1277.2,1285,1258,1261.1,2774253,19.05,0,19.05,41.73116033,1243.3,1354.15,30.58186739,-69.41813261,-10.72290702,-5.427375906,-0.017311687,74280480,HDFC
569,23-04-2015,1276.05,1297.65,1267,1283,3429256,-1.15,1.15,0,41.29284747,1243.3,1354.15,29.54442941,-70.45557059,-11.24121335,-6.590143394,-0.020720617,70851224,HDFC
570,24-04-2015,1245.15,1275,1234.1,1271,1693928,-30.9,30.9,0,31.14946341,1234.1,1354.15,9.204498126,-90.79550187,-13.98414607,-8.06894393,-0.035029256,69157296,HDFC
571,27-04-2015,1211.75,1255,1196.65,1251.9,3816253,-33.4,33.4,0,23.84431836,1196.65,1341.75,10.40661613,-89.59338387,-18.63819142,-10.18279343,-0.071633787,65341043,HDFC
572,28-04-2015,1228.25,1236.4,1188.6,1214,3962095,16.5,0,16.5,32.82430748,1188.6,1335.3,27.02794819,-72.97205181,-20.75588288,-12.29741132,-0.04820024,69303138,HDFC
573,29-04-2015,1201.15,1237,1191.1,1225,4661402,-27.1,27.1,0,26.8290025,1188.6,1316.55,9.808518953,-90.19148105,-24.34033194,-14.70599544,-0.080846342,64641736,HDFC
574,30-04-2015,1170,1200,1160.1,1199.3,7207702,-31.15,31.15,0,21.59721471,1160.1,1315.95,6.35226179,-93.64773821,-29.35617857,-17.63603207,-0.104614678,57434034,HDFC
575,04-05-2015,1202.2,1205.75,1173.45,1179.9,4151853,32.2,0,32.2,36.3918451,1160.1,1315.95,27.01315367,-72.98684633,-30.38276861,-20.18537938,-0.052378513,61585887,HDFC
576,05-05-2015,1180.35,1201.8,1178.1,1197,2910239,-21.85,21.85,0,31.70722536,1160.1,1315.95,12.99326275,-87.00673725,-32.58385462,-22.66507443,-0.061836824,58675648,HDFC
577,06-05-2015,1163.6,1179.95,1151.2,1179.95,5476440,-16.75,16.75,0,28.46600829,1151.2,1315.95,7.526555387,-92.47344461,-35.27320856,-25.18670125,-0.088944566,53199208,HDFC
578,07-05-2015,1154.25,1172.85,1147,1161.65,3674392,-9.35,9.35,0,26.70756306,1147,1315.95,4.291210417,-95.70878958,-37.72414731,-27.69419046,-0.095450805,49524816,HDFC
579,08-05-2015,1185.35,1200,1160.6,1167.45,3665418,31.1,0,31.1,40.75378615,1147,1305.75,24.15748031,-75.84251969,-36.73358197,-29.50206877,-0.048026342,53190234,HDFC
580,11-05-2015,1226.1,1230.55,1191.6,1195,3535741,40.75,0,40.75,54.06361202,1147,1297.65,52.50580816,-47.49419184,-32.28816945,-30.0592889,0.011842377,56725975,HDFC
581,12-05-2015,1191.35,1223,1184.45,1223,3890498,-34.75,34.75,0,44.27639667,1147,1297.65,29.43909725,-70.56090275,-31.20941981,-30.28931508,-0.030042744,52835477,HDFC
582,13-05-2015,1219.4,1228.7,1187.85,1195.5,2388304,28.05,0,28.05,52.31628685,1147,1297.65,48.05841354,-51.94158646,-27.77097585,-29.78564724,0.015193773,55223781,HDFC
583,14-05-2015,1209.7,1224.4,1192,1224.4,1592211,-9.7,9.7,0,49.46838243,1147,1275,48.984375,-51.015625,-25.5343491,-28.93538761,0.033931624,53631570,HDFC
584,15-05-2015,1234.3,1236.45,1205.75,1215,1926050,24.6,0,24.6,56.41173695,1147,1255,80.83333333,-19.16666667,-21.5286233,-27.45403475,0.026701048,55557620,HDFC
585,18-05-2015,1264.3,1271,1227,1234,1779600,30,0,30,63.47397845,1147,1271,94.59677419,-5.403225806,-15.75173131,-25.11357406,0.071122972,57337220,HDFC
586,19-05-2015,1240.55,1264.2,1232.25,1258,1645261,-23.75,23.75,0,55.29089652,1147,1271,75.44354839,-24.55645161,-12.94075632,-22.67901051,0.066130973,55691959,HDFC
587,20-05-2015,1270.05,1273.4,1242.3,1245,1538286,29.5,0,29.5,62.26342055,1147,1273.4,97.34968354,-2.650316456,-8.23767613,-19.79074364,0.100324886,57230245,HDFC
588,21-05-2015,1255.95,1273.4,1245.25,1266.2,1869513,-14.1,14.1,0,57.33237521,1147,1273.4,86.19462025,-13.80537975,-5.583836365,-16.94936218,0.059560467,55360732,HDFC
589,22-05-2015,1288.05,1292.95,1252.1,1256.4,1816951,32.1,0,32.1,64.68019007,1147,1292.95,96.64268585,-3.357314149,-0.880299953,-13.73554974,0.050526058,57177683,HDFC
590,25-05-2015,1252.65,1288,1250,1280,1035874,-35.4,35.4,0,53.05429449,1147,1292.95,72.38780404,-27.61219596,-0.009092793,-10.99025835,0.051454233,56141809,HDFC
591,26-05-2015,1240.45,1260,1233.45,1252.1,1157981,-12.2,12.2,0,49.51515448,1147,1292.95,64.02877698,-35.97122302,-0.299638832,-8.852134444,0.017262588,54983828,HDFC
592,27-05-2015,1239.9,1245,1229,1231,2128114,-0.55,0.55,0,49.34393163,1160.6,1292.95,59.91688704,-40.08311296,-0.567734574,-7.19525447,0.024964867,52855714,HDFC
593,28-05-2015,1229.25,1249.3,1206.55,1242,3185460,-10.65,10.65,0,45.80500667,1184.45,1292.95,41.29032258,-58.70967742,-1.620883835,-6.080380343,-0.004091388,49670254,HDFC
594,29-05-2015,1236.05,1248,1218.75,1229,8462128,6.8,0,6.8,48.52484136,1184.45,1292.95,47.55760369,-52.44239631,-1.885079025,-5.24132008,-0.02234438,58132382,HDFC
595,01-06-2015,1247.75,1255,1236.1,1236.1,1565269,11.7,0,11.7,53.18883205,1187.85,1292.95,56.99333968,-43.00666032,-1.137253843,-4.420506832,0.005803877,59697651,HDFC
596,02-06-2015,1203.1,1250.1,1197.05,1247,2840010,-44.65,44.65,0,38.01991365,1192,1292.95,10.99554235,-89.00445765,-4.100214126,-4.356448291,-0.05271446,56857641,HDFC
597,03-06-2015,1202.85,1217.85,1194,1202.55,1669000,-0.25,0.25,0,37.9499919,1194,1292.95,8.943911066,-91.05608893,-6.394838689,-4.764126371,-0.042278753,55188641,HDFC
598,04-06-2015,1216,1225,1190,1209.2,1559731,13.15,0,13.15,44.18046519,1190,1292.95,25.25497814,-74.74502186,-7.070742962,-5.225449689,-0.05593727,56748372,HDFC
599,05-06-2015,1201.35,1217,1193.8,1213,1562369,-14.65,14.65,0,39.12982036,1190,1292.95,11.02476931,-88.97523069,-8.688380294,-5.91803581,-0.040953179,55186003,HDFC
600,08-06-2015,1176.75,1205,1171,1202,1709199,-24.6,24.6,0,32.03439468,1171,1292.95,4.71504715,-95.28495285,-11.81914025,-7.098256698,-0.051352332,53476804,HDFC
601,09-06-2015,1188.8,1196,1176.65,1179.5,1405906,12.05,0,12.05,38.35248755,1171,1292.95,14.59614596,-85.40385404,-13.17607024,-8.313819407,-0.041213001,54882710,HDFC
602,10-06-2015,1190.55,1205,1182.1,1182.1,1909498,1.75,0,1.75,39.29806747,1171,1292.95,16.03116031,-83.96883969,-13.94943625,-9.440942775,-0.031482611,56792208,HDFC
603,11-06-2015,1164.3,1200,1157.95,1198,2885206,-26.25,26.25,0,31.05403207,1157.95,1288,4.882737409,-95.11726259,-16.49039894,-10.85083401,-0.058047814,53907002,HDFC
604,12-06-2015,1190.4,1194.9,1156,1156,2189916,26.1,0,26.1,44.42858355,1156,1260,33.07692308,-66.92307692,-16.21120562,-11.92290833,-0.045962733,56096918,HDFC
605,15-06-2015,1214.55,1218,1183.35,1189.9,2625930,24.15,0,24.15,53.96314161,1156,1255,59.14141414,-40.85858586,-13.88122561,-12.31457179,0.009517081,58722848,HDFC
606,16-06-2015,1199.05,1213.95,1180.25,1210.3,1624342,-15.5,15.5,0,47.87953038,1156,1255,43.48484848,-56.51515152,-13.13401932,-12.47846129,-0.003159164,57098506,HDFC
607,17-06-2015,1200.9,1217.9,1196.3,1208,2468727,1.85,0,1.85,48.67636749,1156,1255,45.35353535,-54.64646465,-12.25134751,-12.43303854,-0.012417763,59567233,HDFC
608,18-06-2015,1213.3,1219.6,1200,1201,2158585,12.4,0,12.4,54.10314506,1156,1255,57.87878788,-42.12121212,-10.43100523,-12.03263188,0.009947143,61725818,HDFC
609,19-06-2015,1236.85,1247.55,1219,1222.9,3996806,23.55,0,23.55,62.73723947,1156,1250.1,85.91923486,-14.08076514,-7.007306811,-11.02756686,0.05107287,65722624,HDFC
610,22-06-2015,1271.55,1274.5,1238.1,1240,1686424,34.7,0,34.7,71.76701783,1156,1274.5,97.51054852,-2.489451477,-1.476975491,-9.117448588,0.069608008,67409048,HDFC
611,23-06-2015,1285.2,1288.7,1260.25,1272.8,2574782,13.65,0,13.65,74.56465147,1156,1288.7,97.36247174,-2.637528259,3.961625692,-6.501633732,0.079501071,69983830,HDFC
612,24-06-2015,1283.9,1294.85,1265.7,1283.5,3659720,-1.3,1.3,0,73.7614543,1156,1294.85,92.11379186,-7.886208138,8.073787579,-3.58654947,0.102722666,66324110,HDFC
613,25-06-2015,1308.85,1314,1273.75,1278.2,3542983,24.95,0,24.95,78.81496758,1156,1314,96.74050633,-3.259493671,13.19387125,-0.230465326,0.099504368,69867093,HDFC
614,26-06-2015,1287.85,1310,1275.2,1305,2363289,-21,21,0,66.39583799,1156,1314,83.44936709,-16.55063291,15.37976163,2.891580066,0.060351571,67503804,HDFC
615,29-06-2015,1285.5,1293.4,1260,1265.5,1926719,-2.35,2.35,0,65.07188573,1156,1314,81.96202532,-18.03797468,16.72962149,5.659188351,0.072098745,65577085,HDFC
616,30-06-2015,1296.45,1302.85,1278.25,1289.9,3046510,10.95,0,10.95,68.45387096,1156,1314,88.89240506,-11.10759494,18.47005731,8.221362143,0.079565326,68623595,HDFC
617,01-07-2015,1292.7,1302.95,1287.75,1296,2734800,-3.75,3.75,0,65.93124478,1156,1314,86.51898734,-13.48101266,19.32401635,10.44189298,0.065441358,65888795,HDFC
618,02-07-2015,1285.2,1297.9,1280.3,1293.55,2411326,-7.5,7.5,0,60.76377949,1180.25,1314,78.46728972,-21.53271028,19.17456527,12.18842744,0.03909124,63477469,HDFC
619,03-07-2015,1316.05,1323,1278.5,1286.9,2442597,30.85,0,30.85,71.40190677,1180.25,1323,95.13134851,-4.868651489,21.29992906,14.01072776,0.034996658,65920066,HDFC
620,06-07-2015,1317.6,1321.25,1298.75,1304.2,1300415,1.55,0,1.55,71.8444608,1196.3,1323,95.73796369,-4.262036306,22.84601261,15.77778473,0.025210084,67220481,HDFC
621,07-07-2015,1337.3,1347.4,1320,1324,2026043,19.7,0,19.7,77.05223408,1200,1347.4,93.14789688,-6.852103121,25.36848819,17.69592542,0.041592024,69246524,HDFC
622,08-07-2015,1290.05,1332.25,1285.1,1324.85,3407908,-47.25,47.25,0,50.96437594,1219,1347.4,55.33489097,-44.66510903,23.28645636,18.81403161,-0.014363754,65838616,HDFC
623,09-07-2015,1285.3,1299.1,1281.85,1291.1,1370979,-4.75,4.75,0,49.03849248,1238.1,1347.4,43.18389753,-56.81610247,21.01094475,19.25341424,-0.001980044,64467637,HDFC
624,10-07-2015,1283.35,1294.3,1278.9,1287.8,2821543,-1.95,1.95,0,48.1761412,1260,1347.4,26.71624714,-73.28375286,18.83313998,19.16935939,-0.001672501,61646094,HDFC
625,13-07-2015,1323.75,1327,1282.05,1298,2793035,40.4,0,40.4,63.51408156,1260,1347.4,72.94050343,-27.05949657,20.13505203,19.36249792,0.021057503,64439129,HDFC
626,14-07-2015,1318.4,1322.95,1309.1,1322.6,1150810,-5.35,5.35,0,60.7660687,1260,1347.4,66.81922197,-33.18077803,20.49882868,19.58976407,0.019880869,63288319,HDFC
627,15-07-2015,1340.15,1343.95,1311.5,1316.75,1928257,21.75,0,21.75,67.3854008,1260,1347.4,91.70480549,-8.295194508,22.28527673,20.1288666,0.042755991,65216576,HDFC
628,16-07-2015,1359.7,1372.4,1342,1342,2199590,19.55,0,19.55,72.24241553,1260,1372.4,88.70106762,-11.29893238,24.99049641,21.10119256,0.033167433,67416166,HDFC
629,17-07-2015,1326.65,1359.9,1323.7,1359.9,1981172,-33.05,33.05,0,55.98064345,1278.25,1372.4,51.40732873,-48.59267127,24.18871129,21.71869631,0.006868549,65434994,HDFC
630,20-07-2015,1315.35,1333.4,1303,1332.65,2306364,-11.3,11.3,0,51.41482287,1278.5,1372.4,39.24387646,-60.75612354,22.38345274,21.8516476,-0.016413669,63128630,HDFC
631,21-07-2015,1311.6,1329.35,1306.15,1315.35,2360671,-3.75,3.75,0,49.85773114,1278.5,1372.4,35.25026624,-64.74973376,20.414849,21.56428788,0.016704779,60767959,HDFC
632,22-07-2015,1345.75,1349.95,1303.35,1306,1081532,34.15,0,34.15,61.96226034,1278.5,1372.4,71.61874334,-28.38125666,21.36406432,21.52424317,0.047031821,61849491,HDFC
633,23-07-2015,1350.55,1357.45,1341.5,1349.9,1642862,4.8,0,4.8,63.39536669,1278.9,1372.4,76.63101604,-23.36898396,22.2471924,21.66883301,0.052362956,63492353,HDFC
634,24-07-2015,1358.75,1365,1336.65,1355,1915369,8.2,0,8.2,65.92588141,1278.9,1372.4,85.40106952,-14.59893048,23.33970365,22.00300714,0.026440038,65407722,HDFC
635,27-07-2015,1336,1359.15,1329.8,1353.45,2164764,-22.75,22.75,0,53.97993368,1278.9,1372.4,61.06951872,-38.93048128,22.11486542,22.0253788,0.013349515,63242958,HDFC
636,28-07-2015,1304.4,1337,1298.65,1332,3844471,-31.6,31.6,0,41.83146956,1278.9,1372.4,27.27272727,-72.72727273,18.38241535,21.29678611,-0.026676118,59398487,HDFC
637,29-07-2015,1312.05,1332,1305,1310,1996159,7.65,0,7.65,45.27196617,1278.9,1372.4,35.45454545,-64.54545455,15.8589013,20.20920915,-0.035044495,61394646,HDFC
638,30-07-2015,1335.8,1352,1323.35,1327,3233875,23.75,0,23.75,54.84026103,1282.05,1372.4,59.49086884,-40.50913116,15.59564783,19.28649688,0.006897072,64628521,HDFC
639,31-07-2015,1340.4,1350,1329.9,1334.7,2843990,4.6,0,4.6,56.53839741,1298.65,1372.4,56.61016949,-43.38983051,15.5786185,18.54492121,0.019044361,67472511,HDFC
640,03-08-2015,1324.35,1350.5,1315.65,1331.2,2473182,-16.05,16.05,0,49.10463404,1298.65,1372.4,34.84745763,-65.15254237,14.10740043,17.65741705,0.009720952,64999329,HDFC
641,04-08-2015,1302.45,1331.1,1299.7,1324.4,2421674,-21.9,21.9,0,40.68301881,1298.65,1372.4,5.152542373,-94.84745763,11.04696006,16.33532565,-0.032175367,62577655,HDFC
642,05-08-2015,1302.45,1319.95,1300,1307.4,1916199,0,0,0,40.68301881,1298.65,1365,5.72720422,-94.27279578,8.523287864,14.7729181,-0.03561512,62577655,HDFC
643,06-08-2015,1303.85,1313.4,1289,1304.25,2429289,1.4,0,1.4,41.53639059,1289,1365,19.53947368,-80.46052632,6.560601237,13.13045472,-0.040404784,65006944,HDFC
644,07-08-2015,1298.45,1315,1295.6,1306.3,1641394,-5.4,5.4,0,39.03691795,1289,1365,12.43421053,-87.56578947,4.517349877,11.40783375,-0.028106287,63365550,HDFC
645,10-08-2015,1305.5,1333.4,1298.1,1305.95,1534353,7.05,0,7.05,44.10384691,1289,1365,21.71052632,-78.28947368,3.427425309,9.811752066,0.0008433,64899903,HDFC
646,11-08-2015,1290.65,1306.95,1284,1306.75,2196313,-14.85,14.85,0,36.69188516,1284,1365,8.209876543,-91.79012346,1.349821441,8.119365941,-0.016310354,62703590,HDFC
647,12-08-2015,1261.95,1284.5,1257.75,1284.5,1596340,-28.7,28.7,0,26.68955174,1257.75,1365,3.916083916,-96.08391608,-2.582772147,5.978938323,-0.055285222,61107250,HDFC
648,13-08-2015,1256.95,1273,1250.1,1261.95,2627973,-5,5,0,25.30299015,1250.1,1359.15,6.281522238,-93.71847776,-6.033291087,3.576492441,-0.062257535,58479277,HDFC
649,14-08-2015,1299.95,1306.9,1258.75,1268.25,2309630,43,0,43,50.71191103,1250.1,1352,48.9205103,-51.0794897,-5.237734233,1.813647106,-0.018424133,60788907,HDFC
650,17-08-2015,1279.6,1306.2,1271.8,1300,1117732,-20.35,20.35,0,42.76782355,1250.1,1352,28.94995093,-71.05004907,-6.178107248,0.215296235,-0.01754386,59671175,HDFC
651,18-08-2015,1266.1,1285.75,1263.4,1280.5,1425177,-13.5,13.5,0,38.18866407,1250.1,1352,15.7016683,-84.2983317,-7.921384029,-1.412039818,-0.027908941,58245998,HDFC
652,19-08-2015,1256.3,1264.85,1248.7,1259,2263710,-9.8,9.8,0,35.0456724,1248.7,1350.5,7.465618861,-92.53438114,-9.97869337,-3.125370528,-0.036468919,55982288,HDFC
653,20-08-2015,1249.9,1266.9,1246,1258,2591779,-6.4,6.4,0,32.99916411,1246,1350.5,3.732057416,-96.26794258,-11.98736942,-4.897770307,-0.037390735,53390509,HDFC
654,21-08-2015,1228.35,1239,1214,1238,2820891,-21.55,21.55,0,26.89683648,1214,1333.4,12.01842546,-87.98157454,-15.14359859,-6.946935964,-0.059096132,50569618,HDFC
655,24-08-2015,1167.75,1195,1155.85,1194.3,4955839,-60.6,60.6,0,16.81031104,1155.85,1333.4,6.70233737,-93.29766263,-22.27803912,-10.0131566,-0.095223337,45613779,HDFC
656,25-08-2015,1145.55,1187.05,1136.1,1177.3,5830034,-22.2,22.2,0,14.51023092,1136.1,1333.4,4.789660416,-95.21033958,-29.38475989,-13.88747725,-0.092238203,39783745,HDFC
657,26-08-2015,1102.35,1158.15,1093.2,1145,8008888,-43.2,43.2,0,11.10008958,1093.2,1333.4,3.809325562,-96.19067444,-38.0639883,-18.72277946,-0.122996141,31774857,HDFC
658,27-08-2015,1193.9,1204.2,1120,1120,9119089,91.55,0,91.55,43.54388021,1093.2,1333.4,41.92339717,-58.07660283,-37.12704203,-22.40363198,-0.081580061,40893946,HDFC
659,28-08-2015,1201.9,1215.7,1179.1,1201.45,3103897,8,0,8,45.54755483,1093.2,1306.95,50.85380117,-49.14619883,-35.33169048,-24.98924368,-0.060722101,43997843,HDFC
660,31-08-2015,1186.15,1213.8,1176.55,1204,3482922,-15.75,15.75,0,42.14937912,1093.2,1306.9,43.49555452,-56.50444548,-34.77884594,-26.94716413,-0.063146671,40514921,HDFC
661,01-09-2015,1157.4,1176.35,1146,1175,2672450,-28.75,28.75,0,36.42548826,1093.2,1306.9,30.04211511,-69.95788489,-36.24281279,-28.80629386,-0.078723235,37842471,HDFC
662,02-09-2015,1123.15,1179,1110.1,1175,6095077,-34.25,34.25,0,30.69559144,1093.2,1306.9,14.01497426,-85.98502574,-39.70896559,-30.98682821,-0.101408113,31747394,HDFC
663,03-09-2015,1172.05,1176.35,1125.85,1139,3026650,48.9,0,48.9,44.95901573,1093.2,1306.2,37.01877934,-62.98122066,-38.07123385,-32.40370933,-0.045833842,34774044,HDFC
664,04-09-2015,1141.6,1163.95,1131.55,1161,2511258,-30.45,30.45,0,39.167234,1093.2,1285.75,25.13632823,-74.86367177,-38.7833103,-33.67962953,-0.022393492,32262786,HDFC
665,07-09-2015,1155.05,1176.6,1137.05,1145,2977414,13.45,0,13.45,42.91522533,1093.2,1266.9,35.60736903,-64.39263097,-37.82629544,-34.50896271,0.00829296,35240200,HDFC
666,08-09-2015,1171.05,1180,1151.15,1158,2558799,16,0,16,47.36635329,1093.2,1266.9,44.81865285,-55.18134715,-35.3690753,-34.68098523,0.062321404,37798999,HDFC
667,09-09-2015,1186.65,1203.4,1178.5,1183.5,2732329,15.6,0,15.6,51.61106657,1093.2,1239,64.09465021,-35.90534979,-31.79639199,-34.10406658,-0.006072535,40531328,HDFC
668,10-09-2015,1162.75,1174.9,1149.5,1167.55,2039371,-23.9,23.9,0,45.17131852,1093.2,1215.7,56.7755102,-43.2244898,-30.54148181,-33.39154963,-0.032573425,38491957,HDFC
669,11-09-2015,1176.35,1186,1170.25,1175,2011360,13.6,0,13.6,49.32301615,1093.2,1215.7,67.87755102,-32.12244898,-28.1253387,-32.33830744,-0.008262024,40503317,HDFC
670,14-09-2015,1184.7,1188.5,1163.7,1177.35,1505450,8.35,0,8.35,51.90308112,1093.2,1215.7,74.69387755,-25.30612245,-25.24573555,-30.91979306,0.023587351,42008767,HDFC
671,15-09-2015,1179.85,1184.45,1165.45,1176.65,1839713,-4.85,4.85,0,50.19052508,1110.1,1215.7,66.05113636,-33.94886364,-23.0888301,-29.35360047,0.050483017,40169054,HDFC
672,16-09-2015,1196.35,1200,1184,1189.9,1981532,16.5,0,16.5,55.9021442,1110.1,1215.7,81.67613636,-18.32386364,-19.81958703,-27.44679778,0.020732904,42150586,HDFC
673,18-09-2015,1207.05,1235.75,1195.1,1217,4775438,10.7,0,10.7,59.38681728,1110.1,1235.75,77.15877437,-22.84122563,-16.17878877,-25.19319598,0.057331815,46926024,HDFC
674,21-09-2015,1207.3,1209.7,1185.5,1187.8,1318331,0.25,0,0.25,59.4731532,1110.1,1235.75,77.35773975,-22.64226025,-13.12199481,-22.77895575,0.045236137,48244355,HDFC
675,22-09-2015,1168.6,1217,1163.1,1217,2102372,-38.7,38.7,0,43.10578325,1110.1,1235.75,46.55789893,-53.44210107,-13.66471185,-20.95610697,-0.00209214,46141983,HDFC
676,23-09-2015,1165.95,1173.4,1144.25,1155,2474928,-2.65,2.65,0,42.18843515,1125.85,1235.75,36.48771611,-63.51228389,-14.14559032,-19.59400364,-0.017444065,43667055,HDFC
677,24-09-2015,1181.85,1184.4,1151,1165,2492993,15.9,0,15.9,49.61218469,1131.55,1235.75,48.27255278,-51.72744722,-13.09276757,-18.29375642,0.016426575,46160048,HDFC
678,28-09-2015,1172.15,1189,1163.45,1180,1479204,-9.7,9.7,0,45.49939306,1137.05,1235.75,35.56231003,-64.43768997,-12.89249029,-17.2135032,-0.003570366,44680844,HDFC
679,29-09-2015,1216.8,1230.95,1152.5,1164.4,4094857,44.65,0,44.65,62.1601678,1144.25,1235.75,79.28961749,-20.71038251,-9.026831558,-15.57616887,0.027095467,48775701,HDFC
680,30-09-2015,1212.75,1244,1200.75,1244,4753919,-4.05,4.05,0,60.23304178,1144.25,1244,68.6716792,-31.3283208,-6.218388605,-13.70461282,0.027884901,44021782,HDFC
681,01-10-2015,1196.6,1232.8,1192.1,1232.8,3065028,-16.15,16.15,0,52.71359358,1144.25,1244,52.48120301,-47.51879699,-5.235495823,-12.01078942,0.000208969,40956754,HDFC
682,05-10-2015,1256.95,1262.7,1205.25,1210,3654176,60.35,0,60.35,69.26009923,1144.25,1262.7,95.14563107,-4.854368932,0.408485654,-9.526934403,0.041340458,44610930,HDFC
683,06-10-2015,1265.2,1271,1238.35,1268,3144090,8.25,0,8.25,70.86801972,1144.25,1271,95.42406312,-4.575936884,5.483873014,-6.524772919,0.047958254,47755020,HDFC
684,07-10-2015,1277.45,1280,1258,1258,1507689,12.25,0,12.25,73.26402708,1144.25,1280,98.12154696,-1.878453039,10.3750298,-3.144812375,0.093145644,49262709,HDFC
685,08-10-2015,1278.1,1279.8,1258.45,1278.5,1314118,0.65,0,0.65,73.39798177,1144.25,1280,98.60036832,-1.399631676,14.14075059,0.312300218,0.096187658,50576827,HDFC
686,09-10-2015,1291.7,1299,1275.4,1286,2002920,13.6,0,13.6,76.26850146,1144.25,1299,95.28271405,-4.717285945,18.01485377,3.852810928,0.092947498,52579747,HDFC
687,12-10-2015,1270.25,1295.35,1261.95,1292,1610929,-21.45,21.45,0,63.74975704,1144.25,1299,81.42164782,-18.57835218,19.1337112,6.908990982,0.08369236,50968818,HDFC
688,13-10-2015,1278.7,1282.5,1263.2,1270,1768441,8.45,0,8.45,66.26658316,1144.25,1299,86.88206785,-13.11793215,20.46633498,9.620459782,0.050871137,52737259,HDFC
689,14-10-2015,1294.15,1297,1273.65,1273.65,1170630,15.45,0,15.45,70.57639105,1144.25,1299,96.86591276,-3.134087237,22.50965749,12.19829932,0.067120181,53907889,HDFC
690,15-10-2015,1294.7,1305,1288.15,1295.3,1243950,0.55,0,0.55,70.72999503,1151,1305,93.31168831,-6.688311688,23.89790553,14.53822056,0.081982283,55151839,HDFC
691,16-10-2015,1311.6,1315.8,1283.6,1295,1781314,16.9,0,16.9,75.30140986,1152.5,1315.8,97.42804654,-2.57195346,26.06137159,16.84285077,0.043478261,56933153,HDFC
692,19-10-2015,1315.35,1322,1302.45,1320,2824598,3.75,0,3.75,76.25106189,1152.5,1322,96.07669617,-3.923303835,27.75854447,19.02598951,0.039638002,59757751,HDFC
693,20-10-2015,1312.5,1316.4,1302.65,1311.1,2544760,-2.85,2.85,0,73.76393516,1192.1,1322,92.68668206,-7.313317937,28.5445512,20.92970185,0.027437473,57212991,HDFC
694,21-10-2015,1315.75,1320,1305.65,1307.1,1040974,3.25,0,3.25,74.84359514,1192.1,1322,95.18860662,-4.81139338,29.09433367,22.56262821,0.029457789,58253965,HDFC
695,23-10-2015,1337.9,1344,1320.05,1325,2128869,22.15,0,22.15,80.99414554,1205.25,1344,95.6036036,-4.396396396,30.96046713,24.242196,0.035766819,60382834,HDFC
696,26-10-2015,1312.7,1350,1303.4,1347.5,4866457,-25.2,25.2,0,61.31497879,1238.35,1350,66.59202866,-33.40797134,30.05945526,25.40564785,0.033418618,55516377,HDFC
697,27-10-2015,1275.1,1304.9,1271.8,1304.9,4779913,-37.6,37.6,0,43.23130588,1258,1350,18.58695652,-81.41304348,26.01154619,25.52682752,-0.002815359,50736464,HDFC
698,28-10-2015,1266.6,1284.55,1255.45,1275,2978759,-8.5,8.5,0,40.1430755,1255.45,1350,11.79270227,-88.20729773,21.8656169,24.79458539,-0.021288104,47757705,HDFC
699,29-10-2015,1264.65,1285.65,1258.55,1266,3915267,-1.95,1.95,0,39.39808617,1255.45,1350,9.730301428,-90.26969857,18.21264532,23.47819738,-0.02321001,43842438,HDFC
700,30-10-2015,1256.85,1273.55,1246.45,1266.1,2116210,-7.8,7.8,0,36.28972822,1246.45,1350,10.04345727,-89.95654273,14.52085682,21.68672927,-0.041742909,41726228,HDFC
701,02-11-2015,1221.05,1267,1213,1252,3337082,-35.8,35.8,0,25.59538883,1213,1350,5.875912409,-94.12408759,8.607109629,19.07080534,-0.071691945,38389146,HDFC
702,03-11-2015,1221.4,1233.35,1215,1230,2624731,0.35,0,0.35,25.84191424,1213,1350,6.131386861,-93.86861314,3.903665422,16.03737736,-0.069409524,41013877,HDFC
703,04-11-2015,1220.15,1236,1215,1228.75,1258178,-1.25,1.25,0,25.49382808,1213,1350,5.218978102,-94.7810219,0.074429471,12.84478778,-0.07265818,39755699,HDFC
704,05-11-2015,1205.85,1224.8,1200.55,1220,2416892,-14.3,14.3,0,21.64526269,1200.55,1350,3.546336567,-96.45366343,-4.067273106,9.462375603,-0.098699454,37338807,HDFC
705,06-11-2015,1205.4,1224.5,1202.25,1207.2,1645873,-0.45,0.45,0,21.52726404,1200.55,1350,3.245232519,-96.75476748,-7.301743522,6.109551778,-0.081739925,35692934,HDFC
706,09-11-2015,1190.75,1203.3,1177.65,1180,3374264,-14.65,14.65,0,17.86821406,1177.65,1350,7.600812301,-92.3991877,-10.92132298,2.703376826,-0.066151674,32318670,HDFC
707,10-11-2015,1171.35,1185.7,1168.55,1184.2,1260441,-19.4,19.4,0,14.18436779,1168.55,1350,1.543124828,-98.45687517,-15.18029466,-0.873357472,-0.075201326,31058229,HDFC
708,11-11-2015,1177.4,1182.7,1175.1,1178.3,200641,6.05,0,6.05,20.11101158,1168.55,1350,4.877376688,-95.12262331,-17.86147994,-4.270981966,-0.068991421,31258870,HDFC
709,13-11-2015,1178.75,1181.25,1157.55,1178.65,1892688,1.35,0,1.35,21.50674052,1157.55,1350,11.01584827,-88.98415173,-19.65088174,-7.346961921,-0.062139476,33151558,HDFC
710,16-11-2015,1178.4,1189.95,1157.8,1170.1,2208132,-0.35,0.35,0,21.39492372,1157.55,1304.9,14.14998303,-85.85001697,-20.85681328,-10.04893219,-0.034928955,30943426,HDFC
711,17-11-2015,1200.75,1203.95,1184,1190.2,1926695,22.35,0,22.35,43.16665985,1157.55,1285.65,33.7236534,-66.2763466,-19.78104097,-11.99535395,-0.016906828,32870121,HDFC
712,18-11-2015,1178.7,1202.5,1176,1199,1823920,-22.05,22.05,0,32.81891592,1157.55,1285.65,16.51053864,-83.48946136,-20.4717488,-13.69063292,-0.033971233,31046201,HDFC
713,19-11-2015,1214.2,1217,1184.5,1187.25,2607107,35.5,0,35.5,53.51795289,1157.55,1273.55,48.8362069,-51.1637931,-17.94769655,-14.54204564,0.006924576,33653308,HDFC
714,20-11-2015,1205.75,1222.2,1200,1216,2659599,-8.45,8.45,0,49.34252697,1157.55,1267,44.03837369,-55.96162631,-16.43970465,-14.92157745,0.00029036,30993709,HDFC
715,23-11-2015,1191.15,1211,1184.1,1210,2241804,-14.6,14.6,0,42.70079555,1157.55,1236,42.82982792,-57.17017208,-16.23555483,-15.18437292,0.000335923,28751905,HDFC
716,24-11-2015,1218.95,1224.5,1189.65,1191.15,3758223,27.8,0,27.8,55.77853999,1157.55,1236,78.26641173,-21.73358827,-13.67292399,-14.88208314,0.040636872,32510128,HDFC
717,26-11-2015,1222.65,1231.95,1216,1222,2264979,3.7,0,3.7,57.2760192,1157.55,1231.95,87.5,-12.5,-11.2141913,-14.14850477,0.038432139,34775107,HDFC
718,27-11-2015,1230.6,1242.15,1215.8,1225.1,1851264,7.95,0,7.95,60.58505847,1157.55,1242.15,86.34751773,-13.65248227,-8.525848693,-13.02397355,0.043987275,36626371,HDFC
719,30-11-2015,1211.2,1229.4,1204.35,1223.5,6102193,-19.4,19.4,0,49.73822442,1157.55,1242.15,63.41607565,-36.58392435,-7.87001504,-11.99318185,0.027834352,30524178,HDFC
720,01-12-2015,1224.7,1228.15,1213.55,1218.95,2065617,13.5,0,13.5,56.05539972,1157.55,1242.15,79.37352246,-20.62647754,-6.189575397,-10.83246056,0.019945867,32589795,HDFC
721,02-12-2015,1211.75,1233.3,1206.1,1221.3,1513305,-12.95,12.95,0,49.20967398,1157.55,1242.15,64.06619385,-35.93380615,-5.835503593,-9.833069167,0.028039365,31076490,HDFC
722,03-12-2015,1200.2,1208.9,1198.05,1207.35,1577703,-11.55,11.55,0,43.71555387,1157.55,1242.15,50.41371158,-49.58628842,-6.412962964,-9.149047926,-0.011530226,29498787,HDFC
723,04-12-2015,1171.6,1192.65,1169.5,1190,2898773,-28.6,28.6,0,33.14315636,1157.8,1242.15,16.36040308,-83.63959692,-9.07378768,-9.133995877,-0.028322621,26600014,HDFC
724,07-12-2015,1184.6,1187.9,1175.05,1176.3,2494804,13,0,13,40.66883394,1169.5,1242.15,20.78458362,-79.21541638,-10.01803738,-9.310804179,-0.005498888,29094818,HDFC
725,08-12-2015,1171.55,1178.9,1169.5,1178.9,2988127,-13.05,13.05,0,35.97798315,1169.5,1242.15,2.821748107,-97.17825189,-11.68469413,-9.78558217,-0.038885926,26106691,HDFC
726,09-12-2015,1153.25,1170.4,1150,1166.25,1705547,-18.3,18.3,0,30.31949571,1150,1242.15,3.526858383,-96.47314162,-14.31714949,-10.69189563,-0.056761951,24401144,HDFC
727,10-12-2015,1182.3,1185,1154,1155,2489849,29.05,0,29.05,45.90340541,1150,1242.15,35.05154639,-64.94845361,-13.89907719,-11.33333195,-0.039249147,26890993,HDFC
728,11-12-2015,1174.75,1188,1162.2,1185,2219575,-7.55,7.55,0,43.01826627,1150,1242.15,26.85838307,-73.14161693,-14.01541284,-11.86974812,-0.030094122,24671418,HDFC
729,14-12-2015,1188.05,1195,1156.05,1156.05,2052379,13.3,0,13.3,49.47325878,1150,1242.15,41.29137276,-58.70862724,-12.88587053,-12.07297261,-0.029925696,26723797,HDFC
730,15-12-2015,1206.55,1209.5,1180.8,1184.35,2628140,18.5,0,18.5,57.24646375,1150,1242.15,61.36733587,-38.63266413,-10.37827048,-11.73403218,-0.004291314,29351937,HDFC
731,16-12-2015,1219.3,1222.8,1209.2,1211,1910248,12.75,0,12.75,61.906756,1150,1242.15,75.2034726,-24.7965274,-7.278261664,-10.84287808,0.015914014,31262185,HDFC
732,17-12-2015,1240.95,1243.85,1209.5,1220,1921688,21.65,0,21.65,68.61054719,1150,1243.85,96.90996271,-3.090037294,-3.039471147,-9.282196691,0.059192557,33183873,HDFC
733,18-12-2015,1224.85,1247.9,1220.55,1247.9,2755208,-16.1,16.1,0,59.60930476,1150,1247.9,76.45556691,-23.54443309,-0.968174063,-7.619392165,0.033977714,30428665,HDFC
734,21-12-2015,1232.35,1240,1218.2,1218.2,2178186,7.5,0,7.5,62.26992299,1150,1247.9,84.11644535,-15.88355465,1.263960965,-5.842721539,0.051897059,32606851,HDFC
735,22-12-2015,1228.25,1237,1221.5,1233.7,1549227,-4.1,4.1,0,59.78581821,1150,1247.9,79.92849847,-20.07150153,2.671315063,-4.139914219,0.065033601,31057624,HDFC
736,23-12-2015,1239.2,1242,1231.5,1233,1327248,10.95,0,10.95,64.188274,1150,1247.9,91.113381,-8.886618999,4.617004855,-2.388530404,0.048126533,32384872,HDFC
737,24-12-2015,1229.55,1245,1225.4,1243,391634,-9.65,9.65,0,57.7585391,1150,1247.9,81.25638407,-18.74361593,5.318989679,-0.847026387,0.046648223,31993238,HDFC
738,28-12-2015,1227.65,1239,1220.2,1229.55,1658317,-1.9,1.9,0,56.47338448,1150,1247.9,79.31562819,-20.68437181,5.656795571,0.453738004,0.03333193,30334921,HDFC
739,29-12-2015,1234.3,1239.9,1225.6,1226.55,1716336,6.65,0,6.65,60.06211004,1150,1247.9,86.10827375,-13.89172625,6.38747773,1.640485949,0.022999461,32051257,HDFC
740,30-12-2015,1233.7,1244.9,1230.65,1240,1443470,-0.6,0.6,0,59.55095623,1154,1247.9,84.87752929,-15.12247071,6.83929449,2.680247658,0.011810055,30607787,HDFC
741,31-12-2015,1263.75,1274.7,1233.9,1233.9,3215917,30.05,0,30.05,72.88582079,1156.05,1274.7,90.77117573,-9.228824273,9.5124923,4.046696586,0.018373021,33823704,HDFC
742,01-01-2016,1258.45,1266.9,1250.65,1261,676161,-5.3,5.3,0,68.30333073,1156.05,1274.7,86.30425622,-13.69574378,11.07568155,5.45249358,0.02743193,33147543,HDFC
743,04-01-2016,1216.7,1253.9,1212.05,1250,1995329,-41.75,41.75,0,43.46484429,1180.8,1274.7,38.23216187,-61.76783813,8.843699557,6.130734775,-0.012699314,31152214,HDFC
744,05-01-2016,1209.4,1233.45,1206.5,1229.9,2325929,-7.3,7.3,0,40.49394696,1206.5,1274.7,4.252199413,-95.74780059,6.411876629,6.186963146,-0.015347038,28826285,HDFC
745,06-01-2016,1209.3,1220.75,1202.4,1209.6,2746330,-0.1,0.1,0,40.45024553,1202.4,1274.7,9.543568465,-90.45643154,4.425555229,5.834681563,-0.02412847,26079955,HDFC
746,07-01-2016,1179.45,1203.55,1175,1198.85,1780298,-29.85,29.85,0,29.48903688,1175,1274.7,4.463390171,-95.53660983,0.437690254,4.755283301,-0.040746615,24299657,HDFC
747,08-01-2016,1174.4,1230,1169,1189.85,2467149,-5.05,5.05,0,28.00751909,1169,1274.7,5.108798486,-94.89120151,-3.094542307,3.185318179,-0.043375555,21832508,HDFC
748,11-01-2016,1161.55,1171,1150.1,1165,2288312,-12.85,12.85,0,24.40732348,1150.1,1274.7,9.1894061,-90.8105939,-6.851766766,1.17790119,-0.05894029,19544196,HDFC
749,12-01-2016,1151.85,1169.4,1146.05,1169.4,1942208,-9.7,9.7,0,21.94979562,1146.05,1274.7,4.508356005,-95.491644,-10.4911675,-1.155912549,-0.066345141,17601988,HDFC
750,13-01-2016,1167.65,1173.65,1145.35,1157,1830178,15.8,0,15.8,34.36964446,1145.35,1274.7,17.24004639,-82.75995361,-11.96259352,-3.317248744,-0.076043521,19432166,HDFC
751,14-01-2016,1159.3,1167,1147.15,1154.9,3250397,-8.35,8.35,0,31.32963525,1145.35,1274.7,10.78469269,-89.21530731,-13.64519119,-5.382837234,-0.078787397,16181769,HDFC
752,15-01-2016,1149.8,1167.3,1143.15,1160.7,1890878,-9.5,9.5,0,28.07028038,1143.15,1274.7,5.055112125,-94.94488788,-15.56579972,-7.419429731,-0.054984795,14290891,HDFC
753,18-01-2016,1131.8,1157.7,1125.1,1140,2262744,-18,18,0,22.8689022,1125.1,1274.7,4.478609626,-95.52139037,-18.3290594,-9.601355665,-0.064164048,12028147,HDFC
754,19-01-2016,1153,1157.15,1130.9,1132.9,1418630,21.2,0,21.2,38.3846258,1125.1,1274.7,18.64973262,-81.35026738,-18.59396018,-11.39987657,-0.046555859,13446777,HDFC
755,20-01-2016,1136.65,1198.1,1129.15,1140.25,2585069,-16.35,16.35,0,32.55671492,1125.1,1266.9,8.145275035,-91.85472496,-19.89388005,-13.09867726,-0.0362881,10861708,HDFC
756,21-01-2016,1131.1,1147.7,1121.15,1147.05,5451792,-5.55,5.55,0,30.72932294,1121.15,1253.9,7.495291902,-92.5047081,-21.12835994,-14.7046138,-0.036869891,5409916,HDFC
757,22-01-2016,1158.45,1163.2,1135.2,1140,2741456,27.35,0,27.35,47.48864999,1121.15,1233.45,33.21460374,-66.78539626,-19.67299963,-15.69829097,-0.002668848,8151372,HDFC
758,25-01-2016,1174.6,1183.4,1155,1165,2457396,16.15,0,16.15,54.91980076,1121.15,1230,49.10427193,-50.89572807,-17.02024726,-15.96268223,0.019750836,10608768,HDFC
759,27-01-2016,1169.95,1188.45,1162,1176.4,2496568,-4.65,4.65,0,52.4537188,1121.15,1230,44.83233808,-55.16766192,-15.11885725,-15.79391723,0.001969768,8112200,HDFC
760,28-01-2016,1147.75,1159.65,1138,1150,4077193,-22.2,22.2,0,42.05184585,1121.15,1230,24.43729904,-75.56270096,-15.22780973,-15.68069573,-0.009962909,4035007,HDFC
761,29-01-2016,1180,1187.75,1145.05,1147.75,3136336,32.25,0,32.25,56.50841275,1121.15,1198.1,76.47823262,-23.52176738,-12.56698549,-15.05795368,0.026265437,7171343,HDFC
762,01-02-2016,1180.05,1193.95,1170.6,1182.4,2136935,0.05,0,0.05,56.5278138,1121.15,1198.1,76.54320988,-23.45679012,-10.33509202,-14.11338135,0.042631207,9308278,HDFC
763,02-02-2016,1179.8,1192.85,1166.5,1177.6,2338231,-0.25,0.25,0,56.38270832,1121.15,1198.1,76.21832359,-23.78167641,-8.488621733,-12.98842943,0.023243712,6970047,HDFC
764,03-02-2016,1160.95,1180.85,1158.4,1174.4,2896768,-18.85,18.85,0,46.08965265,1121.15,1198.1,51.72189734,-48.27810266,-8.448924249,-12.08052839,0.021378613,4073279,HDFC
765,04-02-2016,1168.35,1177,1163.3,1165.25,1622222,7.4,0,7.4,50.20715277,1121.15,1198.1,61.33853151,-38.66146849,-7.731224804,-11.21066767,0.032932544,5695501,HDFC
766,05-02-2016,1182.95,1186.1,1169,1169,1168106,14.6,0,14.6,57.58240062,1121.15,1198.1,80.31189084,-19.68810916,-5.916147179,-10.15176358,0.021148949,6863607,HDFC
767,08-02-2016,1164.1,1186,1158.05,1185.2,1497068,-18.85,18.85,0,47.17331736,1121.15,1198.1,55.81546459,-44.18453541,-5.930361037,-9.307483068,-0.008939213,5366539,HDFC
768,09-02-2016,1159.9,1168.65,1140.3,1151.1,1662393,-4.2,4.2,0,45.07835318,1121.15,1198.1,50.35737492,-49.64262508,-6.208957524,-8.687777959,-0.008590111,3704146,HDFC
769,10-02-2016,1116.55,1156.75,1110.5,1155,2964666,-43.35,43.35,0,29.48430679,1110.5,1193.95,7.24985021,-92.75014979,-9.814593433,-8.913141054,-0.02718362,739480,HDFC
770,11-02-2016,1066.65,1115.1,1058.05,1110.3,3006630,-49.9,49.9,0,20.20216725,1058.05,1193.95,6.328182487,-93.67181751,-16.50830141,-10.43217313,-0.096059322,-2267150,HDFC
771,12-02-2016,1083.75,1097.1,1067.2,1079,3490711,17.1,0,17.1,29.03581111,1058.05,1193.95,18.91096394,-81.08903606,-20.20042816,-12.38582413,-0.081606712,1223561,HDFC
772,15-02-2016,1080.45,1102,1076,1093.4,4217676,-3.3,3.3,0,28.33730051,1058.05,1193.95,16.48270787,-83.51729213,-23.12616361,-14.53389203,-0.084209188,-2994115,HDFC
773,16-02-2016,1077.15,1090.45,1063.9,1084.5,3312107,-3.3,3.3,0,27.5719602,1058.05,1193.95,14.0544518,-85.9455482,-25.41810833,-16.71073529,-0.072182265,-6306222,HDFC
774,17-02-2016,1076.3,1085.4,1060.15,1078,2237100,-0.85,0.85,0,27.3524046,1058.05,1193.95,13.42899191,-86.57100809,-26.99193272,-18.76697478,-0.078786323,-8543322,HDFC
775,18-02-2016,1069.1,1086.85,1062.7,1086.85,3891721,-7.2,7.2,0,25.37732673,1058.05,1193.95,8.130978661,-91.86902134,-28.49174463,-20.71192875,-0.096242445,-12435043,HDFC
776,19-02-2016,1060.85,1065.4,1046.2,1065,2939450,-8.25,8.25,0,23.16573873,1046.2,1192.85,9.989771565,-90.01022844,-30.00023834,-22.56959067,-0.088695129,-15374493,HDFC
777,22-02-2016,1058.4,1063.75,1047.85,1051,3374621,-2.45,2.45,0,22.49402298,1046.2,1186.1,8.720514653,-91.27948535,-31.03566518,-24.26280557,-0.087507544,-18749114,HDFC
778,23-02-2016,1051.1,1062,1040,1062,3253934,-7.3,7.3,0,20.45490854,1040,1186.1,7.597535934,-92.40246407,-32.07555042,-25.82535454,-0.058618065,-22003048,HDFC
779,24-02-2016,1022.1,1050.8,1018.55,1050.8,4731925,-29,29,0,14.45040085,1018.55,1186.1,2.118770516,-97.88122948,-34.83813229,-27.62791009,-0.041766278,-26734973,HDFC
780,25-02-2016,1042.65,1049.5,1011.45,1022,6122303,20.55,0,20.55,31.00932117,1011.45,1186,17.87453452,-82.12546548,-34.9662163,-29.09557133,-0.037923875,-20612670,HDFC
781,26-02-2016,1053.7,1059,1048.35,1056.7,4862409,11.05,0,11.05,38.40621354,1011.45,1168.65,26.87659033,-73.12340967,-33.78661014,-30.03377909,-0.024758203,-15750261,HDFC
782,29-02-2016,1060.3,1078.5,1022.05,1056,5507689,6.6,0,6.6,42.64425654,1011.45,1156.75,33.62009635,-66.37990365,-31.95088896,-30.41720107,-0.015643132,-10242572,HDFC
783,01-03-2016,1069.45,1073.5,1046.8,1072,5690459,9.15,0,9.15,48.33123522,1011.45,1115.1,55.95754945,-44.04245055,-29.41861864,-30.21748458,-0.006364397,-4552113,HDFC
784,02-03-2016,1099.55,1107,1077,1081.95,4070235,30.1,0,30.1,62.45971798,1011.45,1107,92.20303506,-7.79696494,-24.69825166,-29.113638,0.028481901,-481878,HDFC
785,03-03-2016,1124.15,1135.8,1107.05,1114.7,2754190,24.6,0,24.6,70.15543681,1011.45,1135.8,90.63128267,-9.36871733,-18.75610372,-27.04213114,0.059669133,2272312,HDFC
786,04-03-2016,1129,1134.9,1105,1128,1624796,4.85,0,4.85,71.4852065,1011.45,1135.8,94.53156413,-5.468435867,-13.49993535,-24.33369198,0.06670446,3897108,HDFC
787,08-03-2016,1146.45,1150.8,1119,1120,3121092,17.45,0,17.45,75.93637343,1011.45,1150.8,96.87836383,-3.121636168,-7.835986503,-21.03415089,0.09071449,7018200,HDFC
788,09-03-2016,1128.65,1145,1106,1144,3962894,-17.8,17.8,0,64.15016982,1011.45,1150.8,84.10477216,-15.89522784,-4.729063774,-17.77313346,0.10424616,3055306,HDFC
789,10-03-2016,1153.15,1157,1123.95,1134.8,4555206,24.5,0,24.5,71.23962185,1011.45,1157,97.35486087,-2.645139127,-0.286556636,-14.2758181,0.105979955,7610512,HDFC
790,11-03-2016,1160.5,1167,1146.5,1159,2950536,7.35,0,7.35,73.08223324,1011.45,1167,95.82127933,-4.178720669,3.783630514,-10.66392838,0.101357123,10561048,HDFC
791,14-03-2016,1158.7,1175,1146.75,1168,1239365,-1.8,1.8,0,71.78268639,1011.45,1175,90.03362886,-9.96637114,6.78581554,-7.173979593,0.092803923,9321683,HDFC
792,15-03-2016,1111.35,1148.7,1109.4,1144,3897662,-47.35,47.35,0,46.62034696,1011.45,1175,61.08223785,-38.91776215,5.283415597,-4.682500555,0.039179017,5424021,HDFC
793,16-03-2016,1125.95,1128.7,1095.5,1101.1,3068113,14.6,0,14.6,52.53931616,1011.45,1175,70.00917151,-29.99082849,5.210784124,-2.703843619,0.024009822,8492134,HDFC
794,17-03-2016,1108.05,1152,1104,1135.55,4138764,-17.9,17.9,0,45.41536087,1022.05,1175,56.22752534,-43.77247466,3.666576742,-1.429759547,-0.014321932,4353370,HDFC
795,18-03-2016,1129.3,1133,1104,1111.4,4859516,21.25,0,21.25,53.96551375,1022.05,1175,70.12095456,-29.87904544,4.110099997,-0.321787638,0.000265722,9212886,HDFC
796,21-03-2016,1151.25,1155.85,1128.05,1130,3940026,21.95,0,21.95,61.20773897,1046.8,1175,81.47425897,-18.52574103,6.161748132,0.974919516,0.004186838,13152912,HDFC
797,22-03-2016,1168.1,1174,1136,1142.05,3440836,16.85,0,16.85,65.95224013,1077,1175,92.95918367,-7.040816327,9.043104954,2.588556604,0.034953263,16593748,HDFC
798,23-03-2016,1162.75,1167.7,1143.65,1162.1,2117350,-5.35,5.35,0,63.12384119,1095.5,1175,84.59119497,-15.40880503,10.77074229,4.224993742,0.008325023,14476398,HDFC
799,28-03-2016,1143.35,1170.25,1137.3,1154.5,3943656,-19.4,19.4,0,53.52041053,1095.5,1175,60.18867925,-39.81132075,10.45398246,5.470791486,-0.014778113,10532742,HDFC
800,29-03-2016,1125.75,1142,1120.65,1135.25,3752026,-17.6,17.6,0,46.16795409,1095.5,1175,38.05031447,-61.94968553,8.682686499,6.113170489,-0.028437042,6780716,HDFC
801,30-03-2016,1115.3,1131.35,1110.15,1128.25,4842266,-10.45,10.45,0,42.19657157,1095.5,1175,24.90566038,-75.09433962,6.362352778,6.163006946,0.003554236,1938450,HDFC
802,31-03-2016,1105.6,1118.95,1098,1111,9556036,-9.7,9.7,0,38.63692413,1095.5,1175,12.70440252,-87.29559748,3.698132879,5.670032133,-0.018073627,-7617586,HDFC
803,01-04-2016,1113.4,1117.8,1092.25,1100,3894156,7.8,0,7.8,43.0912277,1092.25,1175,25.55891239,-74.44108761,2.190859364,4.974197579,0.004828302,-3723430,HDFC
804,04-04-2016,1103.7,1124.25,1095.6,1122.5,3275522,-9.7,9.7,0,39.02628065,1092.25,1175,13.83685801,-86.16314199,0.211190834,4.02159623,-0.02266891,-6998952,HDFC
805,05-04-2016,1103.45,1111,1085.5,1102,4368286,-0.25,0.25,0,38.91710577,1085.5,1174,20.28248588,-79.71751412,-1.362181271,2.94484073,-0.041520087,-11367238,HDFC
806,06-04-2016,1102.05,1112.35,1091.2,1112.35,2913779,-1.4,1.4,0,38.22613152,1085.5,1174,18.70056497,-81.29943503,-2.691037693,1.817665045,-0.056544816,-14281017,HDFC
807,07-04-2016,1070.85,1100,1065.5,1100,4883634,-31.2,31.2,0,26.24415649,1065.5,1174,4.930875576,-95.06912442,-6.190386311,0.216054774,-0.079036766,-19164651,HDFC
808,08-04-2016,1079.55,1082.85,1068.15,1071.8,1944688,8.7,0,8.7,33.00107188,1065.5,1174,12.94930876,-87.05069124,-8.167478405,-1.460651862,-0.055800936,-17219963,HDFC
809,11-04-2016,1079.8,1084.7,1060.15,1083.95,3737043,0.25,0,0.25,33.2039669,1060.15,1174,17.25955204,-82.74044796,-9.603462485,-3.089213986,-0.040817233,-13482920,HDFC
810,12-04-2016,1090.5,1091.95,1076.05,1085,1864121,10.7,0,10.7,41.89390862,1060.15,1174,26.65788318,-73.34211682,-9.765518816,-4.424474952,-0.02223617,-11618799,HDFC
811,13-04-2016,1114.95,1117.45,1093.65,1098.1,3361554,24.45,0,24.45,56.7344925,1060.15,1170.25,49.7729337,-50.2270663,-7.830770713,-5.105734104,0.008456946,-8257245,HDFC
812,18-04-2016,1132.4,1139.4,1093.45,1130,3916572,17.45,0,17.45,64.25302521,1060.15,1170.25,65.62216167,-34.37783833,-4.833680082,-5.0513233,0.017064846,-4340673,HDFC
813,20-04-2016,1140,1158.65,1135,1148.7,4669646,7.6,0,7.6,67.12404226,1060.15,1158.65,81.06598985,-18.93401015,-1.824179673,-4.405894575,0.032889372,328973,HDFC
814,21-04-2016,1150.1,1157.45,1140.2,1145,6522775,10.1,0,10.1,70.72892276,1060.15,1158.65,91.31979695,-8.680203046,1.360177396,-3.25268018,0.042276496,6851748,HDFC
815,22-04-2016,1131.9,1152.05,1121.95,1141,2628319,-18.2,18.2,0,57.5974451,1060.15,1158.65,72.84263959,-27.15736041,2.387691597,-2.124605825,0.027085885,4223429,HDFC
816,25-04-2016,1112,1127.5,1106.3,1120,1859499,-19.9,19.9,0,46.66662913,1060.15,1158.65,52.63959391,-47.36040609,1.578049542,-1.384074751,0.038427417,2363930,HDFC
817,26-04-2016,1127.3,1131.85,1103.05,1104,2511483,15.3,0,15.3,54.35188714,1060.15,1158.65,68.17258883,-31.82741117,2.146243949,-0.678011011,0.044231393,4875413,HDFC
818,27-04-2016,1121.5,1128.5,1113.1,1122.4,1866265,-5.8,5.8,0,51.12923672,1060.15,1158.65,62.28426396,-37.71573604,2.104273824,-0.121554044,0.038618263,3009148,HDFC
819,28-04-2016,1085.55,1126.4,1082.05,1121,5791623,-35.95,35.95,0,35.90409455,1060.15,1158.65,25.78680203,-74.21319797,-0.820395349,-0.261322305,-0.004539202,-2782475,HDFC
820,29-04-2016,1088.45,1102.25,1074.2,1084.8,4202421,2.9,0,2.9,37.63270047,1060.15,1158.65,28.73096447,-71.26903553,-2.871114555,-0.783280755,-0.023767882,1419946,HDFC
821,02-05-2016,1091.9,1097,1078.55,1091.45,2394549,3.45,0,3.45,39.85910759,1060.15,1158.65,32.23350254,-67.76649746,-4.169870461,-1.460598696,-0.035764747,3814495,HDFC
822,03-05-2016,1099.6,1116.55,1095.05,1097,3372825,7.7,0,7.7,44.922498,1060.15,1158.65,40.05076142,-59.94923858,-4.525649358,-2.073608829,-0.035438596,7187320,HDFC
823,04-05-2016,1129.9,1138,1098,1099,4419894,30.3,0,30.3,60.15433885,1074.2,1158.65,65.95618709,-34.04381291,-2.335725138,-2.126032091,-0.01756369,11607214,HDFC
824,05-05-2016,1162.65,1176.2,1135,1137,4663686,32.75,0,32.75,70.37279741,1074.2,1176.2,86.71568627,-13.28431373,2.019181018,-1.296989469,0.027166711,16270900,HDFC
825,06-05-2016,1167.8,1173.95,1149.1,1161,2591447,5.15,0,5.15,71.69010282,1074.2,1176.2,91.76470588,-8.235294118,5.818960132,0.126200451,0.050179856,18862347,HDFC
826,09-05-2016,1203.6,1207,1168.1,1168.1,2462695,35.8,0,35.8,79.13221087,1074.2,1207,97.43975904,-2.560240964,11.58552257,2.418064875,0.067683846,21325042,HDFC
827,10-05-2016,1218.55,1220.45,1197,1202.2,2687851,14.95,0,14.95,81.47830043,1074.2,1220.45,98.7008547,-1.299145299,17.16404844,5.367261588,0.086535889,24012893,HDFC
828,11-05-2016,1203.8,1221.5,1200.2,1207.5,3080420,-14.75,14.75,0,72.23334902,1074.2,1221.5,87.98370672,-12.01629328,20.1624485,8.32629897,0.108930957,20932473,HDFC
829,12-05-2016,1195.85,1212.45,1190,1204,1850802,-7.95,7.95,0,67.47221246,1074.2,1221.5,82.58655804,-17.41344196,21.6476628,10.99057174,0.098672424,19081671,HDFC
830,13-05-2016,1166,1203.1,1158.65,1192,2819653,-29.85,29.85,0,52.48466879,1074.2,1221.5,62.32179226,-37.67820774,20.18339865,12.82913712,0.067863357,16262018,HDFC
831,16-05-2016,1186.45,1191,1160.5,1164.4,2309079,20.45,0,20.45,59.58175174,1074.2,1221.5,76.20502376,-23.79497624,20.43751194,14.35081208,0.078983267,18571097,HDFC
832,17-05-2016,1217.85,1230,1191.25,1197.5,3760375,31.4,0,31.4,68.03933327,1074.2,1230,92.20154044,-7.798459564,22.90854074,16.06235782,0.077838747,22331472,HDFC
833,18-05-2016,1208.2,1214.3,1196.4,1205.25,4337073,-9.65,9.65,0,63.33943495,1074.2,1230,86.00770218,-13.99229782,23.81366539,17.61261933,0.039177741,17994399,HDFC
834,19-05-2016,1175.85,1208.55,1173.3,1208.5,2454891,-32.35,32.35,0,49.98409068,1078.55,1230,64.24562562,-35.75437438,21.67080106,18.42425568,0.006893304,15539508,HDFC
835,20-05-2016,1179.55,1193.8,1172.15,1178.1,3001619,3.7,0,3.7,51.33817176,1095.05,1230,62.61578362,-37.38421638,20.04011475,18.74742749,-0.019981722,18541127,HDFC
836,23-05-2016,1160.25,1187.25,1158.4,1184,1882187,-19.3,19.3,0,44.14498457,1098,1230,47.15909091,-52.84090909,16.994533,18.39684859,-0.047843749,16658940,HDFC
837,24-05-2016,1172.75,1177.9,1159.15,1163.9,1650889,12.5,0,12.5,49.4391327,1135,1230,39.73684211,-60.26315789,15.41187456,17.79985379,-0.025793321,18309829,HDFC
838,25-05-2016,1207.05,1212.45,1182.2,1186,2675175,34.3,0,34.3,61.11001528,1149.1,1230,71.631644,-28.368356,16.73244843,17.58637272,0.009365723,20985004,HDFC
839,26-05-2016,1228.25,1235,1191.7,1210.4,2940863,21.2,0,21.2,66.60710586,1158.4,1235,91.18798956,-8.812010444,19.267571,17.92261237,0.05338765,23925867,HDFC
840,27-05-2016,1255.55,1268.4,1218.35,1230,3246784,27.3,0,27.3,72.40312399,1158.4,1268.4,88.31818182,-11.68181818,23.21198246,18.98048639,0.058240971,27172651,HDFC
841,30-05-2016,1233.95,1259,1212.35,1255.2,2889133,-21.6,21.6,0,62.49955737,1158.4,1268.4,68.68181818,-31.31818182,24.31473238,20.04733559,0.013220019,24283518,HDFC
842,31-05-2016,1237.7,1247.8,1222.35,1235.05,5155776,3.75,0,3.75,63.49968709,1158.4,1268.4,72.09090909,-27.90909091,25.20076457,21.07802138,0.024416487,29439294,HDFC
843,01-06-2016,1243.25,1248.35,1230,1242.15,2279936,5.55,0,5.55,65.08963869,1158.4,1268.4,77.13636364,-22.86363636,26.05049617,22.07251634,0.057320236,31719230,HDFC
844,02-06-2016,1260.55,1263.5,1232.55,1236.05,1671551,17.3,0,17.3,69.81824195,1158.4,1268.4,92.86363636,-7.136363636,27.79942554,23.21789818,0.068670256,33390781,HDFC
845,03-06-2016,1254.9,1268.8,1246,1266,1801598,-5.65,5.65,0,66.42763405,1158.4,1268.8,87.40942029,-12.59057971,28.40215452,24.25474945,0.081577246,31589183,HDFC
846,06-06-2016,1251.65,1264.95,1247.7,1261,1879964,-3.25,3.25,0,64.35337586,1158.4,1268.8,84.46557971,-15.53442029,28.29144755,25.06208907,0.067277766,29709219,HDFC
847,07-06-2016,1251.3,1260,1242.8,1256.5,2976354,-0.35,0.35,0,64.10464132,1158.4,1268.8,84.14855072,-15.85144928,27.85438143,25.62054754,0.036659625,26732865,HDFC
848,08-06-2016,1262.5,1267,1247.6,1252.2,2594901,11.2,0,11.2,68.58759123,1158.4,1268.8,94.29347826,-5.706521739,28.08796915,26.11403186,0.027885203,29327766,HDFC
849,09-06-2016,1237.5,1258,1233.35,1257,2153365,-25,25,0,51.89508028,1158.4,1268.8,71.64855072,-28.35144928,25.95658667,26.08254282,-0.01437617,27174401,HDFC
850,10-06-2016,1230.4,1251.7,1228,1233,2144364,-7.1,7.1,0,48.06203033,1159.15,1268.8,64.97948016,-35.02051984,23.42451678,25.55093762,-0.00287694,25030037,HDFC
851,13-06-2016,1205.35,1225,1201.2,1218.05,4888040,-25.05,25.05,0,36.95124701,1182.2,1268.8,26.73210162,-73.26789838,19.17546468,24.27584303,-0.02613719,20141997,HDFC
852,14-06-2016,1198.2,1209.4,1189,1208.3,2396987,-7.15,7.15,0,34.33697476,1189,1268.8,11.52882206,-88.47117794,15.05754108,22.43218264,-0.036235673,17745010,HDFC
853,15-06-2016,1205.15,1209.4,1189.25,1206.2,2921199,6.95,0,6.95,39.16430342,1189,1268.8,20.23809524,-79.76190476,12.2140677,20.38855965,-0.04394907,20666209,HDFC
854,16-06-2016,1200.95,1205.8,1182.15,1198,1840887,-4.2,4.2,0,37.25454833,1182.15,1268.8,21.69648009,-78.30351991,9.51204078,18.21325588,-0.042991473,18825322,HDFC
855,17-06-2016,1227.3,1235.9,1210.35,1215,2684017,26.35,0,26.35,53.62471487,1182.15,1268.8,52.10617426,-47.89382574,9.388663097,16.44833732,-0.01945432,21509339,HDFC
856,20-06-2016,1227.55,1234,1206,1212,2128249,0.25,0,0.25,53.75679154,1182.15,1268.8,52.39469129,-47.60530871,9.204949379,14.99965973,-0.018980261,23637588,HDFC
857,21-06-2016,1238.15,1242.4,1220,1233,2277146,10.6,0,10.6,59.41202635,1182.15,1268.8,64.62781304,-35.37218696,9.801698467,13.96006748,-0.019287129,25914734,HDFC
858,22-06-2016,1238.35,1241.8,1225,1234,2568936,0.2,0,0.2,59.51980119,1182.15,1268.8,64.85862666,-35.14137334,10.17349107,13.2027522,0.000686869,28483670,HDFC
859,23-06-2016,1245.5,1249.45,1228.2,1237.9,1323818,7.15,0,7.15,63.51599421,1182.15,1267,74.66116676,-25.33883324,10.91921473,12.7460447,0.012272432,29807488,HDFC
860,24-06-2016,1222.75,1225.9,1201,1210,2579159,-22.75,22.75,0,46.61955444,1182.15,1267,47.84914555,-52.15085445,9.564220843,12.10967993,0.014435641,27228329,HDFC
861,27-06-2016,1214.6,1229.75,1210.55,1211.1,1699797,-8.15,8.15,0,42.0010979,1182.15,1267,38.24395993,-61.75604007,7.743479528,11.23643985,0.013687197,25528532,HDFC
862,28-06-2016,1228.9,1231.65,1211.25,1211.25,1264518,14.3,0,14.3,51.69032609,1182.15,1258,61.63480554,-38.36519446,7.369468758,10.46304563,0.01970709,26793050,HDFC
863,29-06-2016,1248.55,1251,1231.05,1233.05,1880015,19.65,0,19.65,61.80681321,1182.15,1251.7,95.47088426,-4.529115744,8.559979195,10.08243235,0.039635289,28673065,HDFC
864,30-06-2016,1253.6,1266.25,1243.05,1260,4774341,5.05,0,5.05,64.03984019,1182.15,1266.25,84.95838288,-15.04161712,9.798014675,10.02554881,0.021429153,33447406,HDFC
865,01-07-2016,1242.35,1262.8,1237.7,1253.5,2112124,-11.25,11.25,0,55.6729954,1182.15,1266.25,71.58145065,-28.41854935,9.758891308,9.972217311,0.012056535,31335282,HDFC
866,04-07-2016,1256.25,1266.1,1247,1252,1125696,13.9,0,13.9,62.6330049,1182.15,1266.25,88.10939358,-11.89060642,10.72585857,10.12294556,0.014618584,32460978,HDFC
867,05-07-2016,1260.7,1263.45,1245.7,1257.5,1261841,4.45,0,4.45,64.68150841,1182.15,1266.25,93.40071344,-6.599286564,11.71620775,10.441598,0.018048209,33722819,HDFC
868,07-07-2016,1290.55,1295.4,1253.4,1262,2760950,29.85,0,29.85,75.2030442,1201,1295.4,94.86228814,-5.137711864,14.7398009,11.30123858,0.036170213,36483769,HDFC
869,08-07-2016,1286.9,1301.7,1272.7,1290,2361470,-3.65,3.65,0,72.16965555,1201,1301.7,85.30287984,-14.69712016,16.64956987,12.37090484,0.052463709,34122299,HDFC
870,11-07-2016,1314.1,1322,1298.05,1300,1873706,27.2,0,27.2,79.33640797,1201,1322,93.47107438,-6.52892562,20.1258895,13.92190177,0.081919974,35996005,HDFC
871,12-07-2016,1333.75,1337.8,1319.1,1320.5,1743750,19.65,0,19.65,82.98812807,1201,1337.8,97.03947368,-2.960526316,24.18766825,15.97505507,0.085320205,37739755,HDFC
872,13-07-2016,1330.45,1337.75,1316.15,1333,3059127,-3.3,3.3,0,80.24033705,1201,1337.8,94.62719298,-5.372807018,26.83108273,18.1462606,0.065596091,34680628,HDFC
873,14-07-2016,1336.95,1340.2,1318.05,1328.4,1416877,6.5,0,6.5,81.62321718,1201,1340.2,97.66522989,-2.334770115,29.11488515,20.33998551,0.066488513,36097505,HDFC
874,15-07-2016,1364.1,1370,1320,1325.05,2180001,27.15,0,27.15,86.25823898,1210.55,1370,96.2997805,-3.700219505,32.73820745,22.8196299,0.097999759,38277506,HDFC
875,18-07-2016,1346.35,1386.4,1338,1364,2760273,-17.75,17.75,0,72.46978161,1211.25,1386.4,77.13388524,-22.86611476,33.78795332,25.01329458,0.071721393,35517233,HDFC
876,19-07-2016,1338.55,1355.95,1331.25,1346.35,2534832,-7.8,7.8,0,67.03640324,1231.05,1386.4,69.19858384,-30.80141616,33.60313367,26.7312624,0.061751408,32982401,HDFC
877,20-07-2016,1334.45,1345.8,1325.3,1339.9,2673186,-4.1,4.1,0,64.12066729,1237.7,1386.4,65.06388702,-34.93611298,32.74832473,27.93467486,0.034016505,30309215,HDFC
878,21-07-2016,1332.9,1345,1328.15,1335.95,1524359,-1.55,1.55,0,62.92676539,1237.7,1386.4,64.02151984,-35.97848016,31.58175561,28.66409101,0.035744813,28784856,HDFC
879,22-07-2016,1357,1361.15,1326.7,1333.95,1523892,24.1,0,24.1,72.20988915,1245.7,1386.4,79.10447761,-20.89552239,32.23037804,29.37734842,0.032645917,30308748,HDFC
880,25-07-2016,1382,1387,1350.4,1355.5,2693450,25,0,25,78.61825933,1245.7,1387,96.46142958,-3.538570418,34.36556224,30.37499118,0.036176195,33002198,HDFC
881,26-07-2016,1367.45,1385,1362.2,1383.7,2852587,-14.55,14.55,0,68.07624093,1253.4,1387,85.36676647,-14.63323353,34.48611326,31.1972156,0.027810139,30149611,HDFC
882,27-07-2016,1387.7,1398.1,1368.55,1376.9,3451819,20.25,0,20.25,73.73249716,1272.7,1398.1,91.70653907,-8.293460925,35.80294254,32.11836099,0.037959535,33601430,HDFC
883,28-07-2016,1402.15,1410,1374,1390.3,5473387,14.45,0,14.45,77.07663484,1298.05,1410,92.98794105,-7.012058955,37.5793422,33.21055723,0.027893849,39074817,HDFC
884,29-07-2016,1374.5,1407.95,1373,1407.95,3347082,-27.65,27.65,0,60.16503389,1316.15,1410,62.17368141,-37.82631859,36.3371557,33.83587692,0.020908382,35727735,HDFC
885,01-08-2016,1374.3,1397.45,1368,1385,3040038,-0.2,0.2,0,60.05505879,1316.15,1410,61.96057539,-38.03942461,34.9338796,34.05547746,0.026708005,32687697,HDFC
886,02-08-2016,1342.15,1373.35,1334.05,1371.8,3509100,-32.15,32.15,0,44.84938798,1318.05,1410,26.20989668,-73.79010332,30.8716675,33.41871547,0.005770167,29178597,HDFC
887,03-08-2016,1325.45,1342.15,1316.4,1342.15,3806460,-16.7,16.7,0,38.94008469,1316.4,1410,9.668803419,-90.33119658,26.00501509,31.93597539,-0.005589317,25372137,HDFC
888,04-08-2016,1320.15,1333.7,1313.1,1331.3,2223224,-5.3,5.3,0,37.14774816,1313.1,1410,7.275541796,-92.7244582,21.47296531,29.84337338,-0.02715549,23148913,HDFC
889,05-08-2016,1342.1,1350,1322.55,1330,2210679,21.95,0,21.95,48.47976181,1313.1,1410,29.92776058,-70.07223942,19.42850505,27.76039971,-0.028871201,25359592,HDFC
890,08-08-2016,1367.45,1370.6,1345.6,1350,2196658,25.35,0,25.35,58.4600589,1313.1,1410,56.08875129,-43.91124871,19.6275347,26.13382671,0,27556250,HDFC
891,09-08-2016,1343,1376,1331.5,1375,3160963,-24.45,24.45,0,48.09220039,1313.1,1410,30.85655315,-69.14344685,17.60936666,24.4289347,-0.032211573,24395287,HDFC
892,10-08-2016,1337.15,1349,1325.35,1343.35,2397117,-5.85,5.85,0,45.84744087,1313.1,1410,24.81940144,-75.18059856,15.36083766,22.61531529,-0.04635738,21998170,HDFC
893,11-08-2016,1348.45,1353.1,1331,1339,2774737,11.3,0,11.3,50.95017691,1313.1,1410,36.48090815,-63.51909185,14.32554186,20.9573606,-0.018952346,24772907,HDFC
894,12-08-2016,1382.15,1383.8,1352.55,1354,4666213,33.7,0,33.7,62.96037276,1313.1,1410,71.25902993,-28.74097007,16.03947772,19.97378403,0.005711999,29439120,HDFC
895,16-08-2016,1358.55,1385,1348.1,1378,3860834,-23.6,23.6,0,52.56101746,1313.1,1410,46.90402477,-53.09597523,15.31689781,19.04240678,0.012219201,25578286,HDFC
896,17-08-2016,1366.9,1372.45,1350.5,1350.5,2627238,8.35,0,8.35,55.55781179,1313.1,1410,55.52115583,-44.47884417,15.24231927,18.28238928,0.031272398,28205524,HDFC
897,18-08-2016,1374.3,1377.75,1363.75,1369.5,2889535,7.4,0,7.4,58.254463,1313.1,1407.95,64.52293094,-35.47706906,15.60050054,17.74601153,0.041018066,31095059,HDFC
898,19-08-2016,1369.4,1376.15,1358.8,1375,2925379,-4.9,4.9,0,55.67345254,1313.1,1397.45,66.74570243,-33.25429757,15.31246021,17.25930127,0.020341256,28169680,HDFC
899,22-08-2016,1377.55,1380.8,1357.6,1370,2069513,8.15,0,8.15,59.14715269,1313.1,1385,89.63838665,-10.36161335,15.56242908,16.91992683,0.00738601,30239193,HDFC
900,23-08-2016,1375.15,1380,1362.25,1373.65,1766716,-2.4,2.4,0,57.6130624,1313.1,1385,86.30041725,-13.69958275,15.38947101,16.61383567,0.023938943,28472477,HDFC
901,24-08-2016,1382.85,1386.8,1366.25,1386.3,1692693,7.7,0,7.7,61.32635814,1313.1,1386.8,94.64043419,-5.359565807,15.69282899,16.42963433,0.034177168,30165170,HDFC
902,25-08-2016,1357.5,1390,1352.3,1380.65,1846727,-25.35,25.35,0,46.01372078,1322.55,1390,51.81616012,-48.18383988,13.72944474,15.88959641,0.006711409,28318443,HDFC
903,26-08-2016,1366.35,1371.15,1349,1361.5,1478521,8.85,0,8.85,50.9474739,1325.35,1390,63.41840681,-36.58159319,12.74070272,15.25981767,-0.011431465,29796964,HDFC
904,29-08-2016,1375.5,1379.5,1357.65,1364.9,1371236,9.15,0,9.15,55.76962054,1325.35,1390,77.57153906,-22.42846094,12.55076863,14.71800786,0.012476537,31168200,HDFC
905,30-08-2016,1392.1,1394.25,1373.6,1379.9,2039705,16.6,0,16.6,63.31819054,1325.35,1394.25,96.87953556,-3.120464441,13.58314769,14.49103583,0.018435877,33207905,HDFC
906,31-08-2016,1405.45,1414,1390,1390.1,5712564,13.35,0,13.35,68.33317536,1331,1414,89.69879518,-10.30120482,15.30215524,14.65325971,0.022666085,38920469,HDFC
907,01-09-2016,1424.75,1430,1405.3,1412,2336511,19.3,0,19.3,74.21387398,1348.1,1430,93.58974359,-6.41025641,18.01417363,15.32544249,0.040419162,41256980,HDFC
908,02-09-2016,1439.15,1441.95,1421.05,1426.5,2435712,14.4,0,14.4,77.76816374,1348.1,1441.95,97.01651572,-2.983484283,21.08240259,16.47683451,0.04471707,43692692,HDFC
909,06-09-2016,1458.05,1462,1442,1453,2249067,18.9,0,18.9,81.60748949,1349,1462,96.50442478,-3.495575221,24.75372268,18.13221215,0.060284333,45941759,HDFC
910,07-09-2016,1427.15,1464,1416.25,1464,2282112,-30.9,30.9,0,61.55432968,1349,1464,67.95652174,-32.04347826,24.8830621,19.48238214,0.032035289,43659647,HDFC
911,08-09-2016,1437.8,1442.8,1428.1,1432.75,1135659,10.65,0,10.65,64.97685719,1349,1464,77.2173913,-22.7826087,25.55040139,20.69598599,0.059152855,44795306,HDFC
912,09-09-2016,1410.65,1442,1396.55,1442,3028457,-27.15,27.15,0,51.49295834,1349,1464,53.60869565,-46.39130435,23.61626093,21.28004098,0.032422147,41766849,HDFC
913,12-09-2016,1399.05,1410,1373.7,1390,2322859,-11.6,11.6,0,46.71393353,1349,1464,43.52173913,-56.47826087,20.90642141,21.20531706,0.017121047,39443990,HDFC
914,14-09-2016,1392.2,1397.9,1378.5,1391.05,2442783,-6.85,6.85,0,43.93557526,1349,1464,37.56521739,-62.43478261,17.99863921,20.56398149,7.18E-05,37001207,HDFC
915,15-09-2016,1410.05,1412.5,1390.4,1393.1,1519406,17.85,0,17.85,52.44056928,1349,1464,53.08695652,-46.91304348,16.9392812,19.83904144,0.003272973,38520613,HDFC
916,16-09-2016,1397.35,1417,1393,1416.7,5047304,-12.7,12.7,0,46.63301182,1349,1464,42.04347826,-57.95652174,14.9031542,18.85186399,-0.019231444,33473309,HDFC
917,19-09-2016,1392.8,1401,1386,1399.9,1515698,-4.55,4.55,0,44.59158144,1357.65,1464,33.05124589,-66.94875411,12.77509852,17.6365109,-0.032206511,31957611,HDFC
918,20-09-2016,1393.1,1396,1382.25,1390,2123466,0.3,0,0.3,44.77550215,1373.6,1464,21.57079646,-78.42920354,10.98616489,16.30644169,-0.044545797,34081077,HDFC
919,21-09-2016,1392.35,1406,1388.55,1392.35,2262794,-0.75,0.75,0,44.35083893,1373.7,1464,20.65337763,-79.34662237,9.399551192,14.92506359,-0.024384262,31818283,HDFC
920,22-09-2016,1413.25,1419.4,1402,1405.9,2777234,20.9,0,20.9,57.3555253,1373.7,1464,43.79844961,-56.20155039,9.716596855,13.88337025,-0.017074697,34595517,HDFC
921,23-09-2016,1425.1,1427.2,1412,1418,1369990,11.85,0,11.85,63.01060195,1373.7,1464,56.9213732,-43.0786268,10.79956315,13.26660883,0.010243505,35965507,HDFC
922,26-09-2016,1412.45,1424.2,1403.1,1417.3,1999367,-12.65,12.65,0,54.16347378,1373.7,1464,42.91251384,-57.08748616,10.51585226,12.71645751,0.009577928,33966140,HDFC
923,27-09-2016,1418.9,1423,1406,1415.7,1288154,6.45,0,6.45,57.66089142,1373.7,1464,50.05537099,-49.94462901,10.6882628,12.31081857,0.019178279,35254294,HDFC
924,28-09-2016,1423.55,1432,1417.15,1418.1,1322605,4.65,0,4.65,60.18781965,1373.7,1442.8,72.14182344,-27.85817656,11.07247888,12.06315063,0.009574129,36576899,HDFC
925,29-09-2016,1401.4,1432.95,1392.6,1428.5,3386269,-22.15,22.15,0,45.32096668,1373.7,1442,40.55636896,-59.44363104,9.480369217,11.54659435,0.002898343,33190630,HDFC
926,30-09-2016,1393.45,1399.2,1381.8,1396.9,2719424,-7.95,7.95,0,41.11512118,1373.7,1432.95,33.33333333,-66.66666667,7.49076342,10.73542816,0.000466686,30471206,HDFC
927,03-10-2016,1425.5,1430.2,1386,1401,1189432,32.05,0,32.05,58.87011306,1378.5,1432.95,86.31772268,-13.68227732,8.40328579,10.26899969,0.023257483,31660638,HDFC
928,04-10-2016,1432.4,1435.2,1416.1,1423.25,2188072,6.9,0,6.9,61.73610418,1381.8,1435.2,94.75655431,-5.243445693,9.57288838,10.12977743,0.028764319,33848710,HDFC
929,05-10-2016,1423.15,1437.35,1414.35,1435,1127576,-9.25,9.25,0,55.72932512,1381.8,1437.35,74.43744374,-25.56255626,9.642259202,10.03227378,0.00700513,32721134,HDFC
930,06-10-2016,1426,1433.9,1418.2,1425.2,1367425,2.85,0,2.85,57.20945983,1381.8,1437.35,79.5679568,-20.4320432,9.814076692,9.988634364,0.000631535,34088559,HDFC
931,07-10-2016,1403.7,1426,1398.4,1426,1275355,-22.3,22.3,0,43.94469716,1381.8,1437.35,39.42394239,-60.57605761,8.057932827,9.602494057,-0.00619491,32813204,HDFC
932,10-10-2016,1391.45,1412,1386.15,1408,966179,-12.25,12.25,0,38.31393111,1381.8,1437.35,17.37173717,-82.62826283,5.613000364,8.804595318,-0.019345972,31847025,HDFC
933,13-10-2016,1338.9,1400,1335.05,1385,3233878,-52.55,52.55,0,23.44466409,1335.05,1437.35,3.76344086,-96.23655914,-0.558533621,6.93196953,-0.059464016,28613147,HDFC
934,14-10-2016,1316.05,1342,1312.9,1340.8,3014689,-22.85,22.85,0,19.62368397,1312.9,1437.35,2.531137003,-97.468863,-7.210208012,4.103534022,-0.060903382,25598458,HDFC
935,17-10-2016,1301.95,1322.95,1297.15,1321.95,2134599,-14.1,14.1,0,17.58329974,1297.15,1437.35,3.423680456,-96.57631954,-13.46425253,0.589976712,-0.065664358,23463859,HDFC
936,18-10-2016,1355.25,1357.7,1306.55,1307,2217709,53.3,0,53.3,43.29817645,1297.15,1437.35,41.44079886,-58.55920114,-13.95885433,-2.319789497,-0.049280954,25681568,HDFC
937,19-10-2016,1342.15,1359.25,1336.15,1358.9,1840483,-13.1,13.1,0,39.77844879,1297.15,1437.35,32.09700428,-67.90299572,-15.23230185,-4.902291966,-0.063006144,23841085,HDFC
938,20-10-2016,1359.95,1368,1345.3,1348,1708024,17.8,0,17.8,46.58600352,1297.15,1437.35,44.79315264,-55.20684736,-14.63648663,-6.849130899,-0.04440853,25549109,HDFC
939,21-10-2016,1336.55,1361.45,1331.05,1361.45,3175886,-23.4,23.4,0,39.76720265,1297.15,1437.35,28.10271041,-71.89728959,-15.86954894,-8.653214507,-0.06272791,22373223,HDFC
940,24-10-2016,1344,1350,1333.05,1341.35,923522,7.45,0,7.45,42.84066597,1297.15,1437.35,33.41654779,-66.58345221,-16.06047184,-10.13466597,-0.042530455,23296745,HDFC
941,25-10-2016,1340.1,1349.25,1327.5,1344.8,1051311,-3.9,3.9,0,41.55973991,1297.15,1437.35,30.63480742,-69.36519258,-16.3381411,-11.375361,-0.036903949,22245434,HDFC
942,26-10-2016,1334.65,1343.95,1319,1336.6,1797435,-5.45,5.45,0,39.6482514,1297.15,1437.35,26.74750357,-73.25249643,-16.80425643,-12.46114008,-0.003174248,20447999,HDFC
943,27-10-2016,1378.55,1383,1328.6,1336.1,3054221,43.9,0,43.9,57.72144585,1297.15,1433.9,59.52468007,-40.47531993,-13.47595071,-12.66410221,0.047490597,23502220,HDFC
944,28-10-2016,1391.7,1393,1362.4,1374.7,2929858,13.15,0,13.15,61.68697085,1297.15,1426,73.37989911,-26.62010089,-9.665728837,-12.06442753,0.068935059,26432078,HDFC
945,30-10-2016,1377.5,1398,1375,1398,110205,-14.2,14.2,0,55.2321657,1297.15,1412,69.96081846,-30.03918154,-7.703125048,-11.19216704,0.016417635,26321873,HDFC
946,01-11-2016,1417.2,1431.75,1377,1382.6,4195608,39.7,0,39.7,66.53000531,1297.15,1431.75,89.19019316,-10.80980684,-2.910736039,-9.535880838,0.055917744,30517481,HDFC
947,02-11-2016,1404.35,1408.95,1392.25,1400,1717505,-12.85,12.85,0,60.79953695,1297.15,1431.75,79.64338782,-20.35661218,-0.14791575,-7.65828782,0.032648259,28799976,HDFC
948,03-11-2016,1401.6,1411.45,1395.7,1400.9,1447474,-2.75,2.75,0,59.53331425,1297.15,1431.75,77.60029718,-22.39970282,1.798999471,-5.766830362,0.048670083,27352502,HDFC
949,04-11-2016,1386.15,1408,1377.55,1408,1818296,-15.45,15.45,0,52.45197552,1306.55,1431.75,63.57827476,-36.42172524,2.071380348,-4.19918822,0.031361607,25534206,HDFC
950,07-11-2016,1381.4,1401.95,1373.35,1401.35,2013931,-4.75,4.75,0,50.32833547,1319,1431.75,55.34368071,-44.65631929,1.882261317,-2.982898312,0.030818596,23520275,HDFC
951,08-11-2016,1391.35,1394.6,1366.1,1381.4,1611902,9.95,0,9.95,54.75583955,1319,1431.75,64.16851441,-35.83148559,2.506373057,-1.885044039,0.042483048,25132177,HDFC
952,09-11-2016,1350.8,1362.1,1310,1335.55,4422950,-40.55,40.55,0,38.58363879,1310,1431.75,33.51129363,-66.48870637,-0.267970998,-1.56162943,-0.020129847,20709227,HDFC
953,10-11-2016,1324.55,1364.55,1311,1361,3981742,-26.25,26.25,0,31.61013043,1310,1431.75,11.95071869,-88.04928131,-4.532565674,-2.155816679,-0.048250341,16727485,HDFC
954,11-11-2016,1268.35,1311.4,1263.25,1310,3340486,-56.2,56.2,0,21.85312407,1263.25,1431.75,3.026706231,-96.97329377,-12.30531004,-4.185715352,-0.07923775,13386999,HDFC
955,15-11-2016,1225.75,1258,1201,1258,6489223,-42.6,42.6,0,17.20762461,1201,1431.75,10.72589382,-89.27410618,-21.65312617,-7.679197516,-0.135090319,6897776,HDFC
956,16-11-2016,1255.4,1265.45,1221.8,1237.7,4265216,29.65,0,29.65,29.28074579,1201,1431.75,23.57529794,-76.42470206,-26.3649123,-11.41634047,-0.106063303,11162992,HDFC
957,17-11-2016,1250.2,1270.55,1238.1,1260,2462361,-5.2,5.2,0,28.44146416,1201,1431.75,21.32177681,-78.67822319,-30.1708426,-15.1672409,-0.108019406,8700631,HDFC
958,18-11-2016,1249.8,1261.65,1243.4,1250.2,2742765,-0.4,0.4,0,28.36929052,1201,1431.75,21.14842904,-78.85157096,-32.84077839,-18.7019484,-0.098365978,5957866,HDFC
959,21-11-2016,1221.95,1250,1213.75,1250,2648780,-27.85,27.85,0,23.5652025,1201,1431.75,9.079089924,-90.92091008,-36.78000696,-22.31756011,-0.115426379,3309086,HDFC
960,22-11-2016,1249.7,1252.5,1225.8,1230,2649077,27.75,0,27.75,36.02133812,1201,1411.45,23.14088857,-76.85911143,-37.23347656,-25.3007434,-0.101807597,5958163,HDFC
961,23-11-2016,1226.9,1255,1205,1250,3248078,-22.8,22.8,0,31.20097129,1201,1411.45,12.30696127,-87.69303873,-38.98324931,-28.03724458,-0.091723423,2710085,HDFC
962,24-11-2016,1217.65,1229.85,1212.1,1217.1,3969055,-9.25,9.25,0,29.36165838,1201,1408,8.043478261,-91.95652174,-40.64779206,-30.55935408,-0.080706655,-1258970,HDFC
963,25-11-2016,1244.05,1257.15,1210.2,1227,3185195,26.4,0,26.4,40.84546017,1201,1401.95,21.42323961,-78.57676039,-39.3827154,-32.32402634,-0.01915875,1926225,HDFC
964,28-11-2016,1246.7,1252,1234,1236.1,2670157,2.65,0,2.65,41.9387157,1201,1394.6,23.6053719,-76.3946281,-37.73135658,-33.40549239,0.017091577,4596382,HDFC
965,29-11-2016,1255.8,1284.95,1241.6,1241.6,3448317,9.1,0,9.1,45.90032537,1201,1364.55,33.50657291,-66.49342709,-35.28164404,-33.78072272,0.000318624,8044699,HDFC
966,30-11-2016,1263.1,1272.1,1237.55,1254.2,4722267,7.3,0,7.3,49.11407538,1201,1364.55,37.97003974,-62.02996026,-32.37794739,-33.50016765,0.010318349,12766966,HDFC
967,01-12-2016,1270,1285.75,1259.2,1268.4,2474051,6.9,0,6.9,52.21025593,1201,1311.4,62.5,-37.5,-29.18356457,-32.63684704,0.016162586,15241017,HDFC
968,02-12-2016,1236.8,1260.5,1233,1260.4,2832229,-33.2,33.2,0,39.02681862,1201,1285.75,42.24188791,-57.75811209,-28.99669981,-31.90881759,0.012152707,12408788,HDFC
969,05-12-2016,1215.55,1239.95,1183.15,1236.8,5623284,-21.25,21.25,0,32.89283157,1183.15,1285.75,31.57894737,-68.42105263,-30.21500576,-31.57005523,-0.027326558,6785504,HDFC
970,06-12-2016,1243.4,1259.8,1218.05,1218.05,2799494,27.85,0,27.85,45.77990135,1183.15,1285.75,58.72319688,-41.27680312,-28.60353601,-30.97675138,0.013448529,9584998,HDFC
971,07-12-2016,1264.95,1283.45,1246,1246.4,4418144,21.55,0,21.55,53.7156736,1183.15,1285.75,79.72709552,-20.27290448,-25.29593393,-29.84058789,0.038845317,14003142,HDFC
972,08-12-2016,1289.85,1295,1270.5,1270.5,2704208,24.9,0,24.9,61.27262941,1183.15,1295,95.39561913,-4.604380867,-20.42991027,-27.95845237,0.036815241,16707350,HDFC
973,09-12-2016,1268.25,1289.7,1260,1287,2333398,-21.6,21.6,0,52.66578746,1183.15,1295,76.08404113,-23.91595887,-18.107756,-25.98831309,0.017285634,14373952,HDFC
974,12-12-2016,1264.5,1278,1254.15,1266.9,1219745,-3.75,3.75,0,51.22440363,1183.15,1295,72.73133661,-27.26866339,-16.38119347,-24.06688917,0.006927855,13154207,HDFC
975,13-12-2016,1278.55,1281.5,1250,1269.4,1656438,14.05,0,14.05,56.3847876,1183.15,1295,85.29280286,-14.70719714,-13.72099555,-21.99771044,0.012231811,14810645,HDFC
976,14-12-2016,1266.55,1279,1257,1279,1628885,-12,12,0,51.06099053,1183.15,1295,74.56414841,-25.43585159,-12.43769524,-20.0857074,-0.002716535,13181760,HDFC
977,15-12-2016,1259.2,1277.4,1255.25,1262,1731691,-7.35,7.35,0,47.86688879,1183.15,1295,67.99284756,-32.00715244,-11.87684519,-18.44393496,0.018111255,11450069,HDFC
978,16-12-2016,1269.15,1278,1262,1262,2775322,9.95,0,9.95,52.5074319,1183.15,1295,76.88869021,-23.11130979,-10.5083519,-16.85681835,0.044095266,14225391,HDFC
979,19-12-2016,1247.9,1263.9,1242.65,1263,1279508,-21.25,21.25,0,43.06179838,1183.15,1295,57.89003129,-42.10996871,-11.01157395,-15.68776947,0.003619109,12945883,HDFC
980,20-12-2016,1235.55,1255.9,1227.8,1245.9,1935652,-12.35,12.35,0,38.42631543,1183.15,1295,46.84845776,-53.15154224,-12.26553339,-15.00332225,-0.023242025,11010231,HDFC
981,21-12-2016,1235.6,1256.95,1230.25,1242,3217980,0.05,0,0.05,38.45726329,1183.15,1295,46.89316048,-53.10683952,-13.10421349,-14.6235005,-0.042059154,14228211,HDFC
982,22-12-2016,1217.4,1237.85,1213.25,1234.8,2238703,-18.2,18.2,0,31.7540396,1183.15,1295,30.6213679,-69.3786321,-15.06381513,-14.71156343,-0.040094619,11989508,HDFC
983,23-12-2016,1224.85,1232.3,1208.25,1217.4,1560501,7.45,0,7.45,36.9451098,1208.25,1295,19.13544669,-80.86455331,-15.83314615,-14.93587997,-0.031356267,13550009,HDFC
984,26-12-2016,1219.5,1224.25,1206,1220,747342,-5.35,5.35,0,34.75463576,1206,1295,15.16853933,-84.83146067,-16.68224429,-15.28515284,-0.046185132,12802667,HDFC
985,27-12-2016,1232.15,1237,1211.45,1221.9,872827,12.65,0,12.65,43.83910968,1206,1295,29.38202247,-70.61797753,-16.14826426,-15.45777512,-0.027160396,13675494,HDFC
986,28-12-2016,1237.95,1248.05,1222.9,1238.9,2032787,5.8,0,5.8,47.69214019,1206,1289.7,38.17204301,-61.82795699,-15.08319998,-15.38286009,-0.016875794,15708281,HDFC
987,29-12-2016,1257.2,1261.55,1229.9,1234.7,2005422,19.25,0,19.25,58.57576592,1206,1281.5,67.81456954,-32.18543046,-12.54124705,-14.81453748,-0.009415751,17713703,HDFC
988,30-12-2016,1262.6,1269.75,1249.5,1263.35,1388842,5.4,0,5.4,61.18953055,1206,1281.5,74.96688742,-25.03311258,-9.975999059,-13.8468298,0.01177979,19102545,HDFC
989,02-01-2017,1217.1,1272,1213.7,1272,2369360,-45.5,45.5,0,37.92470687,1206,1279,15.20547945,-84.79452055,-11.48213241,-13.37389032,-0.014932621,16733185,HDFC
990,03-01-2017,1214,1222.6,1200.5,1218.7,3203369,-3.1,3.1,0,36.8240489,1200.5,1278,17.41935484,-82.58064516,-12.77859436,-13.25483113,-0.017481386,13529816,HDFC
991,04-01-2017,1212.1,1224.5,1197.25,1215.8,2805972,-1.9,1.9,0,36.08345842,1197.25,1278,18.39009288,-81.60990712,-13.80028284,-13.36392147,-0.00435354,10723844,HDFC
992,05-01-2017,1217.2,1220.4,1205.1,1215.7,3339784,5.1,0,5.1,39.83130382,1197.25,1272,26.68896321,-73.31103679,-14.03664524,-13.49846622,-0.006245663,14063628,HDFC
993,06-01-2017,1222.35,1232,1218.8,1219,2774461,5.15,0,5.15,43.67919028,1197.25,1272,33.57859532,-66.42140468,-13.65104147,-13.52898127,0.002337023,16838089,HDFC
994,09-01-2017,1223.55,1229,1212.6,1225,2016528,1.2,0,1.2,44.63119418,1197.25,1272,35.18394649,-64.81605351,-13.09763634,-13.44271229,-0.00697967,18854617,HDFC
995,10-01-2017,1217.25,1227.95,1213.05,1225,2669824,-6.3,6.3,0,40.48567929,1197.25,1272,26.75585284,-73.24414716,-13.01736011,-13.35764185,-0.016721192,16184793,HDFC
996,11-01-2017,1230.05,1233,1218.2,1224.7,1353730,12.8,0,12.8,51.12761906,1197.25,1272,43.87959866,-56.12040134,-11.78503702,-13.04312088,-0.021595609,17538523,HDFC
997,12-01-2017,1221.1,1242.95,1217.6,1234,1477834,-8.95,8.95,0,44.68163348,1197.25,1272,31.90635452,-68.09364548,-11.39919942,-12.71433659,-0.032868684,16060689,HDFC
998,13-01-2017,1247.5,1250.6,1222.15,1224.95,2131709,26.4,0,26.4,61.29157384,1197.25,1272,67.22408027,-32.77591973,-8.861016694,-11.94367261,0.024977405,18192398,HDFC
999,16-01-2017,1256.9,1264,1240.25,1245.1,1694061,9.4,0,9.4,65.54224526,1197.25,1272,79.7993311,-20.2006689,-6.021574195,-10.75925293,0.035337727,19886459,HDFC
1000,17-01-2017,1245.8,1261,1234.95,1258.35,1185487,-11.1,11.1,0,57.01200322,1197.25,1272,64.94983278,-35.05016722,-4.613787917,-9.530159926,0.027802987,18700972,HDFC
1001,18-01-2017,1249.05,1260.95,1245.65,1246.3,1491317,3.25,0,3.25,58.82254212,1197.25,1272,69.29765886,-30.70234114,-3.198983421,-8.263924625,0.026166612,20192289,HDFC
1002,19-01-2017,1242.4,1251.7,1232.9,1251.7,1599732,-6.65,6.65,0,53.50243484,1197.25,1272,60.40133779,-39.59866221,-2.584547038,-7.128049108,0.016402831,18592557,HDFC
1003,20-01-2017,1237.3,1245,1230.6,1236.15,1408933,-5.1,5.1,0,49.53774455,1197.25,1264,60,-40,-2.480535091,-6.198546304,0.011237792,17183624,HDFC
1004,23-01-2017,1259.75,1262,1232,1234.7,2265524,22.45,0,22.45,63.33704943,1197.25,1264,93.6329588,-6.367041199,-0.579892853,-5.074815614,0.034914767,19449148,HDFC
1005,24-01-2017,1280.75,1282,1260,1263.1,1937436,21,0,21,71.69209967,1205.1,1282,98.37451235,-1.625487646,2.591036455,-3.5416452,0.041217837,21386584,HDFC
1006,25-01-2017,1337.4,1341.45,1279.7,1284,5273331,56.65,0,56.65,83.43921287,1212.6,1341.45,96.85681024,-3.143189756,9.564943617,-0.920327437,0.095241995,26659915,HDFC
1007,27-01-2017,1373.7,1379,1329.15,1329.15,4017493,36.3,0,36.3,87.32737727,1212.6,1379,96.81490385,-3.185096154,17.81555528,2.826849107,0.101162325,30677408,HDFC
1008,30-01-2017,1371.9,1379.4,1360,1370.4,2427494,-1.8,1.8,0,86.16984596,1213.05,1379.4,95.49143372,-4.508566276,23.93309371,7.048098027,0.091494948,28249914,HDFC
1009,31-01-2017,1365.85,1388.2,1353,1371.45,2588181,-6.05,6.05,0,81.95678244,1217.6,1388.2,86.89917937,-13.10082063,27.97067403,11.23261323,0.096363782,25661733,HDFC
1010,01-02-2017,1412.1,1417.45,1369.65,1370,2637813,46.25,0,46.25,87.39354125,1217.6,1417.45,97.32299224,-2.677007756,34.504725,15.88703558,0.13053921,28299546,HDFC
1011,02-02-2017,1401.3,1411,1385.7,1411,2336054,-10.8,10.8,0,80.83111304,1222.15,1417.45,91.73067076,-8.269329237,38.36924101,20.38347667,0.127897618,25963492,HDFC
1012,03-02-2017,1397.45,1408,1385.6,1401.5,2144208,-3.85,3.85,0,78.40931584,1230.6,1417.45,89.29622692,-10.70377308,40.6526169,24.43730471,0.12943506,23819284,HDFC
1013,06-02-2017,1400.3,1411.85,1388.6,1402,2029593,2.85,0,2.85,78.94806096,1230.6,1417.45,90.82151458,-9.178485416,42.20565935,27.99097564,0.111569756,25848877,HDFC
1014,07-02-2017,1407.25,1410,1388.4,1399.6,2731391,6.95,0,6.95,80.32916857,1230.6,1417.45,94.54107573,-5.458924271,43.49587029,31.09195457,0.098770252,28580268,HDFC
1015,08-02-2017,1401.1,1410,1383.8,1410,2263272,-6.15,6.15,0,75.2861701,1230.6,1417.45,91.24966551,-8.750334493,43.52044159,33.57765197,0.047629729,26316996,HDFC
1016,09-02-2017,1396.9,1421.2,1385.65,1402,2389616,-4.2,4.2,0,71.73735784,1230.6,1421.2,87.25078699,-12.74921301,42.70869042,35.40385966,0.016888695,23927380,HDFC
1017,10-02-2017,1388.55,1410,1382.8,1408,1637560,-8.35,8.35,0,64.7372147,1232,1421.2,82.74312896,-17.25687104,40.91989745,36.50706722,0.012136453,22289820,HDFC
1018,13-02-2017,1392.05,1398.4,1372.6,1398.4,1638938,3.5,0,3.5,66.32642106,1260,1421.2,81.91687345,-18.08312655,39.33130014,37.0719138,0.019182194,23928758,HDFC
1019,14-02-2017,1398.15,1403.65,1388.05,1398,1564027,6.1,0,6.1,69.12466198,1279.7,1421.2,83.71024735,-16.28975265,38.12506236,37.28254351,-0.009878904,25492785,HDFC
1020,15-02-2017,1399.15,1409.8,1389.5,1399.9,2323380,1,0,1,69.60246865,1329.15,1421.2,76.04562738,-23.95437262,36.8253027,37.19109535,-0.00153429,27816165,HDFC
1021,16-02-2017,1393.55,1403,1386.25,1394.15,2017252,-5.6,5.6,0,63.27528375,1353,1421.2,59.45747801,-40.54252199,34.94058727,36.74099374,-0.002790798,25798913,HDFC
1022,17-02-2017,1402.5,1432.65,1400.2,1425,2075335,8.95,0,8.95,68.54781975,1353,1432.65,62.14689266,-37.85310734,33.77973515,36.14874202,0.001571092,27874248,HDFC
1023,20-02-2017,1393.3,1402.85,1386,1401.55,1470475,-9.2,9.2,0,58.57366303,1369.65,1432.65,37.53968254,-62.46031746,31.75137825,35.26926927,-0.009912951,26403773,HDFC
1024,21-02-2017,1412.45,1414,1389.85,1393.1,734159,19.15,0,19.15,69.30180002,1372.6,1432.65,66.36136553,-33.63863447,31.328006,34.48101661,0.008100778,27137932,HDFC
1025,22-02-2017,1394.1,1415,1391.8,1415,2494083,-18.35,18.35,0,53.87570671,1372.6,1432.65,35.80349709,-64.19650291,29.17547211,33.41990771,-0.002004438,24643849,HDFC
1026,23-02-2017,1385.7,1404.9,1378,1401,4125739,-8.4,8.4,0,48.2078329,1372.6,1432.65,21.81515404,-78.18484596,26.48644446,32.03321506,-0.002052501,20518110,HDFC
1027,27-02-2017,1375.7,1389.45,1368.1,1389.45,2822066,-10,10,0,42.12096196,1368.1,1432.65,11.77381875,-88.22618125,23.28009579,30.28259121,-0.011745268,17696044,HDFC
1028,28-02-2017,1370.05,1383.95,1368.4,1377,2318175,-5.65,5.65,0,38.91751225,1368.1,1432.65,3.02091402,-96.97908598,20.05198677,28.23647032,-0.020097987,15377869,HDFC
1029,01-03-2017,1400.55,1405,1369.2,1369.8,2163448,30.5,0,30.5,58.55208993,1368.1,1432.65,50.27110767,-49.72889233,19.72737728,26.53465171,0.001000608,17541317,HDFC
1030,02-03-2017,1399,1415.4,1392,1403,2671884,-1.55,1.55,0,57.46886846,1368.1,1432.65,47.86986832,-52.13013168,19.12459348,25.05264007,0.003910875,14869433,HDFC
1031,03-03-2017,1371.2,1397,1366,1392.3,1137208,-27.8,27.8,0,41.55808964,1366,1432.65,7.801950488,-92.19804951,16.21671906,23.28545586,-0.022317291,13732225,HDFC
1032,06-03-2017,1365.95,1392,1362.5,1379,2236116,-5.25,5.25,0,39.19360541,1362.5,1432.65,4.918032787,-95.08196721,13.33486053,21.2953368,-0.019629656,11496109,HDFC
1033,07-03-2017,1365.4,1374.4,1362.75,1374.4,1507326,-0.55,0.55,0,38.92589164,1362.5,1432.65,4.133998574,-95.86600143,10.8811553,19.2125005,-0.033310914,9988783,HDFC
1034,08-03-2017,1367.7,1376.8,1361.3,1368.1,2330472,2.3,0,2.3,40.87458171,1361.3,1432.65,8.969866854,-91.03013315,9.018210687,17.17364254,-0.018936949,12319255,HDFC
1035,09-03-2017,1371.5,1381.9,1362.6,1368.25,2205255,3.8,0,3.8,44.26473529,1361.3,1432.65,14.2957253,-85.7042747,7.759000967,15.29071422,-0.010247528,14524510,HDFC
1036,10-03-2017,1373.8,1383.35,1369,1378,1607599,2.3,0,2.3,46.4106658,1361.3,1415.4,23.10536044,-76.89463956,6.867494765,13.60607033,-0.001381115,16132109,HDFC
1037,14-03-2017,1424.15,1428,1413.3,1415.2,6249576,50.35,0,50.35,72.83224846,1361.3,1428,94.22788606,-5.772113943,10.10728341,12.90631295,0.03948761,22381685,HDFC
1038,15-03-2017,1426.1,1435,1416.65,1425.4,2598530,1.95,0,1.95,73.41791782,1361.3,1435,87.92401628,-12.07598372,12.6859522,12.8622408,0.018242833,24980215,HDFC
1039,16-03-2017,1450.25,1454.75,1431.15,1431.65,3406772,24.15,0,24.15,79.6781725,1361.3,1454.75,95.18459069,-4.81540931,16.48820322,13.58743328,0.03663331,28386987,HDFC
1040,17-03-2017,1451.2,1458.5,1438.7,1458.5,3588003,0.95,0,0.95,79.89310514,1361.3,1458.5,92.48971193,-7.510288066,19.35505854,14.74095833,0.058343057,31974990,HDFC
1041,20-03-2017,1457.75,1464.95,1446.95,1449.8,1745773,6.55,0,6.55,81.45360832,1361.3,1464.95,93.05354559,-6.946454414,21.90310691,16.17338805,0.067205974,33720763,HDFC
1042,21-03-2017,1458.4,1473.45,1449.35,1452.15,2087458,0.65,0,0.65,81.61697243,1361.3,1473.45,86.58047258,-13.41952742,23.7016849,17.67904742,0.068111909,35808221,HDFC
1043,22-03-2017,1442.3,1454.75,1434.05,1449.9,1866922,-16.1,16.1,0,65.20265189,1361.3,1473.45,72.22469906,-27.77530094,23.55639205,18.85451635,0.054544125,33941299,HDFC
1044,23-03-2017,1456.65,1460.9,1439.85,1444.6,2342002,14.35,0,14.35,71.16635379,1361.3,1473.45,85.02006242,-14.97993758,24.31883905,19.94738089,0.062085308,36283301,HDFC
1045,24-03-2017,1462.6,1467.25,1450,1458,1701119,5.95,0,5.95,73.35138383,1361.3,1473.45,90.32545698,-9.674543023,25.11370392,20.98064549,0.06463823,37984420,HDFC
1046,27-03-2017,1474.7,1478.5,1455,1455,2418666,12.1,0,12.1,77.37457684,1361.3,1478.5,96.75767918,-3.242320819,26.4155074,22.06761787,0.035494857,40403086,HDFC
1047,28-03-2017,1504.1,1508,1477.1,1477.7,2272786,29.4,0,29.4,84.10308655,1361.3,1508,97.34151329,-2.658486708,29.47970663,23.55003563,0.054694622,42675872,HDFC
1048,29-03-2017,1522.05,1531,1498.5,1510.1,3595260,17.95,0,17.95,86.85664049,1362.6,1531,94.68527316,-5.314726841,32.97639028,25.43530656,0.049508705,46271132,HDFC
1049,30-03-2017,1519.95,1528.4,1510.55,1520,8057156,-2.1,2.1,0,84.8721513,1369,1531,93.17901235,-6.820987654,35.17263655,27.38277256,0.047374587,38213976,HDFC
1050,31-03-2017,1502.1,1520.2,1496.55,1520.2,2816509,-17.85,17.85,0,69.33518504,1413.3,1531,75.44604928,-24.55395072,35.06858293,28.91993463,0.030423598,35397467,HDFC
1051,03-04-2017,1533.65,1537.2,1502.05,1509.65,2302442,31.55,0,31.55,77.67143705,1416.65,1537.2,97.05516383,-2.944836168,37.10422659,30.55679302,0.051597641,37699909,HDFC
1052,05-04-2017,1490.15,1530,1486.75,1525.1,4839266,-43.5,43.5,0,54.22157035,1431.15,1537.2,55.63413484,-44.36586516,34.80617843,31.4066701,0.033176177,32860643,HDFC
1053,06-04-2017,1482.6,1490,1468.1,1490,3533800,-7.55,7.55,0,51.13012554,1434.05,1537.2,47.06737761,-52.93262239,32.00678255,31.52669259,0.017814849,29326843,HDFC
1054,07-04-2017,1484.75,1494,1466.25,1474.9,2366116,2.15,0,2.15,52.02881423,1434.05,1537.2,49.15172079,-50.84827921,29.62028398,31.14541087,0.015144264,31692959,HDFC
1055,10-04-2017,1467.5,1484,1465.05,1484,2200153,-17.25,17.25,0,44.45987772,1434.05,1537.2,32.42850218,-67.57149782,26.03689867,30.12370843,-0.004882349,29492806,HDFC
1056,11-04-2017,1476.85,1486.95,1461.2,1465.1,2166320,9.35,0,9.35,49.09168103,1434.05,1537.2,41.4929714,-58.5070286,23.67855521,28.83467779,-0.018117146,31659126,HDFC
1057,12-04-2017,1466.65,1476.45,1460,1475,2663565,-10.2,10.2,0,44.42792547,1439.85,1537.2,27.52953261,-72.47046739,20.74733392,27.21720901,-0.036398279,28995561,HDFC
1058,13-04-2017,1474.9,1484.7,1461.15,1470,1773012,8.25,0,8.25,48.95370875,1450,1537.2,28.55504587,-71.44495413,18.87247583,25.54826238,-0.029639133,30768573,HDFC
1059,17-04-2017,1479.55,1494.45,1474.8,1475,1213004,4.65,0,4.65,51.52135128,1455,1537.2,29.86618005,-70.13381995,17.55943914,23.95049773,-0.015012316,31981577,HDFC
1060,18-04-2017,1480.05,1491,1474,1482,1784505,0.5,0,0.5,51.82201702,1460,1537.2,25.97150259,-74.02849741,16.37048516,22.43449522,-0.034949304,33766082,HDFC
1061,19-04-2017,1490.2,1492.3,1470.2,1491.55,1546962,10.15,0,10.15,57.93309639,1460,1537.2,39.11917098,-60.88082902,16.06209689,21.16001555,3.36E-05,35313044,HDFC
1062,20-04-2017,1517.1,1531.75,1487.1,1490,2905255,26.9,0,26.9,69.68993043,1460,1537.2,73.96373057,-26.03626943,17.78330725,20.48467389,0.023269931,38218299,HDFC
1063,21-04-2017,1507.45,1526.75,1490.95,1519.9,1520049,-9.65,9.65,0,62.46386881,1460,1537.2,61.46373057,-38.53626943,18.15937454,20.01961402,0.015288769,36698250,HDFC
1064,24-04-2017,1530.7,1538.55,1507.45,1509.8,1550370,23.25,0,23.25,70.86278457,1460,1538.55,90.00636537,-9.993634628,20.10177058,20.03604533,0.04306644,38248620,HDFC
1065,25-04-2017,1548.4,1557.6,1531,1535,2420240,17.7,0,17.7,75.64896769,1460,1557.6,90.57377049,-9.426229508,22.80647663,20.59013159,0.04844771,40668860,HDFC
1066,26-04-2017,1586,1590,1551.2,1551.2,3596629,37.6,0,37.6,82.63899202,1460,1590,96.92307692,-3.076923077,27.66507567,22.00512041,0.081375925,44265489,HDFC
1067,27-04-2017,1566.5,1589.95,1559.05,1582,4533632,-19.5,19.5,0,70.52471922,1460,1590,81.92307692,-18.07692308,29.60084327,23.52426498,0.062105905,39731857,HDFC
1068,28-04-2017,1537.15,1566,1532.15,1564.1,2850999,-29.35,29.35,0,56.21355959,1460,1590,59.34615385,-40.65384615,28.43882823,24.50717763,0.038930756,36880858,HDFC
1069,02-05-2017,1584.75,1590.75,1538.9,1547,4472856,47.6,0,47.6,68.26459292,1460,1590.75,95.41108987,-4.588910134,31.00147937,25.80603798,0.070740853,41353714,HDFC
1070,03-05-2017,1571.3,1591.85,1563,1588,4028393,-13.45,13.45,0,62.64346276,1460,1591.85,84.41410694,-15.58589306,31.58302679,26.96143574,0.054422225,37325321,HDFC
1071,04-05-2017,1564.35,1587.4,1556,1573,5810079,-6.95,6.95,0,59.71189834,1461.15,1591.85,78.95944912,-21.04055088,31.12431863,27.79401232,0.031144948,31515242,HDFC
1072,05-05-2017,1546.85,1570.2,1540.95,1570.1,2299986,-17.5,17.5,0,52.5649435,1470.2,1591.85,63.00863132,-36.99136868,29.01422741,28.03805534,0.026136854,29215256,HDFC
1073,08-05-2017,1529.5,1549,1527.15,1542,1887869,-17.35,17.35,0,46.23448044,1470.2,1591.85,48.74640362,-51.25359638,25.64632998,27.55971026,-0.000783955,27327387,HDFC
1074,09-05-2017,1523.5,1542.8,1517.85,1537.9,2041977,-6,6,0,44.11455374,1470.2,1591.85,43.81422113,-56.18577887,22.23676556,26.49512132,-0.016081116,25285410,HDFC
1075,10-05-2017,1572,1575.25,1527.2,1532,2965910,48.5,0,48.5,60.85506817,1487.1,1591.85,81.05011933,-18.94988067,23.18098984,25.83229503,-0.008827238,28251320,HDFC
1076,11-05-2017,1565.3,1581,1557,1581,2648011,-6.7,6.7,0,58.08180459,1490.95,1591.85,73.68681863,-26.31318137,23.12212294,25.29026061,-0.000766039,25603309,HDFC
1077,12-05-2017,1549.8,1566.2,1539.35,1565,1294006,-15.5,15.5,0,51.78263444,1507.45,1591.85,50.17772512,-49.82227488,21.57603493,24.54741547,0.008229516,24309303,HDFC
1078,15-05-2017,1559.5,1572.6,1554.1,1554.5,1270297,9.7,0,9.7,55.28442375,1517.85,1591.85,56.28378378,-43.71621622,20.89262085,23.81645655,-0.015933112,25579600,HDFC
1079,16-05-2017,1566.55,1569,1554,1558,2114918,7.05,0,7.05,57.85147314,1517.85,1591.85,65.81081081,-34.18918919,20.68148309,23.18946186,-0.003022975,27694518,HDFC
1080,17-05-2017,1552.5,1570.95,1549.75,1565.5,2161434,-14.05,14.05,0,51.10503975,1517.85,1591.85,46.82432432,-53.17567568,19.15957763,22.38348501,-0.007575031,25533084,HDFC
1081,18-05-2017,1537.05,1558.6,1526.5,1547,2404372,-15.45,15.45,0,44.51793076,1517.85,1591.85,25.94594595,-74.05405405,16.51638016,21.21006404,-0.006335456,23128712,HDFC
1082,19-05-2017,1520.6,1548,1515.35,1545,2142433,-16.45,16.45,0,38.43221263,1515.35,1591.85,6.862745098,-93.1372549,12.94502738,19.55705671,-0.005818895,20986279,HDFC
1083,22-05-2017,1519.85,1530,1510.25,1530,1920867,-0.75,0.75,0,38.1578004,1510.25,1591.85,11.76470588,-88.23529412,9.939608223,17.63356701,-0.002395799,19065412,HDFC
1084,23-05-2017,1511.5,1537.2,1503.45,1521.7,1408855,-8.35,8.35,0,34.95188677,1503.45,1587.4,9.589041096,-90.4109589,6.805566341,15.46796688,-0.038486005,17656557,HDFC
1085,24-05-2017,1524.85,1541.75,1512.4,1519,2209471,13.35,0,13.35,43.68093024,1503.45,1581,27.59509994,-72.40490006,5.337521375,13.44187778,-0.025841692,19866028,HDFC
1086,25-05-2017,1539.75,1546,1530.5,1533.9,4099792,14.9,0,14.9,51.97963507,1503.45,1581,46.80851064,-53.19148936,5.31512123,11.81652647,-0.006484708,23965820,HDFC
1087,26-05-2017,1547.9,1563,1530.25,1538.1,1871008,8.15,0,8.15,56.06546363,1503.45,1581,57.31785945,-42.68214055,5.887142526,10.63064968,-0.007438282,25836828,HDFC
1088,29-05-2017,1598.85,1601.25,1546,1546,3464406,50.95,0,50.95,72.77482496,1503.45,1601.25,97.54601227,-2.45398773,10.33260488,10.57104072,0.020618557,29301234,HDFC
1089,30-05-2017,1579.5,1604,1575.05,1595.7,1605211,-19.35,19.35,0,62.3786319,1503.45,1604,75.63401293,-24.36598707,12.15417675,10.88766793,0.017391304,27696023,HDFC
1090,31-05-2017,1569.85,1596.15,1565.4,1581,4907685,-9.65,9.65,0,57.64041924,1503.45,1604,66.03679761,-33.96320239,12.6730245,11.24473924,0.021339579,22788338,HDFC
1091,01-06-2017,1583.75,1587.4,1551.8,1551.8,2990228,13.9,0,13.9,62.38866167,1503.45,1604,79.86076579,-20.13923421,14.04393912,11.80457922,0.041529659,25778566,HDFC
1092,02-06-2017,1604.65,1612.8,1582,1582,3427957,20.9,0,20.9,68.51220591,1503.45,1612.8,92.54686786,-7.453132144,16.6252091,12.76870519,0.05579498,29206523,HDFC
1093,05-06-2017,1606.15,1612,1591.15,1606.4,2988075,1.5,0,1.5,68.93109866,1503.45,1612.8,93.91860997,-6.081390032,18.57776867,13.93051789,0.062619914,32194598,HDFC
1094,06-06-2017,1605.75,1624.85,1602.5,1610,2170920,-0.4,0.4,0,68.65009087,1503.45,1624.85,84.26688633,-15.73311367,19.86393052,15.11720042,0.053054399,30023678,HDFC
1095,07-06-2017,1599.35,1611.5,1590.6,1609.7,1726464,-6.4,6.4,0,63.84503764,1503.45,1624.85,78.99505766,-21.00494234,20.13469629,16.12069959,0.038707582,28297214,HDFC
1096,08-06-2017,1633.55,1635,1605,1608.9,2289492,34.2,0,34.2,74.74453542,1503.45,1635,98.89775751,-1.102242493,22.84558461,17.46567659,0.055333032,30586706,HDFC
1097,09-06-2017,1647.2,1649,1620.1,1628,2633241,13.65,0,13.65,77.82338382,1503.45,1649,98.76331158,-1.236688423,25.79804031,19.13214934,0.030240485,33219947,HDFC
1098,12-06-2017,1647.5,1651.8,1633.85,1644,2000556,0.3,0,0.3,77.89173157,1512.4,1651.8,96.91535151,-3.084648494,27.84115471,20.87395041,0.043051599,35220503,HDFC
1099,13-06-2017,1667.65,1682.2,1642.05,1642.05,2737084,20.15,0,20.15,82.15424319,1530.25,1682.2,90.42448174,-9.575518263,30.73201466,22.84556326,0.062298946,37957587,HDFC
1100,14-06-2017,1651.1,1668,1644,1661.55,6519614,-16.55,16.55,0,69.46223227,1530.25,1682.2,79.53274103,-20.46725897,31.32648312,24.54174723,0.042525651,31437973,HDFC
1101,15-06-2017,1636.85,1653.7,1629.55,1648.7,5678766,-14.25,14.25,0,60.21946341,1546,1682.2,66.70337739,-33.29662261,30.29848566,25.69309492,0.020066681,25759207,HDFC
1102,16-06-2017,1640.85,1651,1629.15,1634.3,2692532,4,0,4,61.86304912,1551.8,1682.2,68.2898773,-31.7101227,29.46688098,26.44785213,0.021604458,28451739,HDFC
1103,19-06-2017,1654.2,1660,1645.2,1659,2907637,13.35,0,13.35,67.09800613,1551.8,1682.2,78.52760736,-21.47239264,29.5444912,27.06717994,0.030172816,31359376,HDFC
1104,20-06-2017,1631.5,1660,1627.9,1651.15,2304515,-22.7,22.7,0,52.86161072,1551.8,1682.2,61.1196319,-38.8803681,27.45778136,27.14530023,0.020101916,29054861,HDFC
1105,21-06-2017,1628.25,1638,1615.5,1632.15,2359678,-3.25,3.25,0,51.07152167,1582,1682.2,46.15768463,-53.84231537,25.25072629,26.76638544,-0.003244468,26695183,HDFC
1106,22-06-2017,1653.8,1660,1626.1,1626.1,3438975,25.55,0,25.55,62.56937516,1590.6,1682.2,68.99563319,-31.00436681,25.27197116,26.46750258,0.004006799,30134158,HDFC
1107,23-06-2017,1651.35,1661,1642.1,1660,2590704,-2.45,2.45,0,60.98377937,1590.6,1682.2,66.3209607,-33.6790393,24.80517473,26.13503701,0.002336874,27543454,HDFC
1108,27-06-2017,1651.05,1667,1639.7,1655.7,3612290,-0.3,0.3,0,60.76621093,1590.6,1682.2,65.99344978,-34.00655022,24.13283936,25.73459748,-0.009954127,23931164,HDFC
1109,28-06-2017,1629,1658.8,1623.1,1656.5,1683069,-22.05,22.05,0,46.65123967,1605,1682.2,31.0880829,-68.9119171,21.57208841,24.90209567,-0.013385016,22248095,HDFC
1110,29-06-2017,1632.2,1654.9,1620.1,1629.4,2783220,3.2,0,3.2,48.64861329,1615.5,1682.2,25.03748126,-74.96251874,19.57523694,23.83672392,-0.002840822,25031315,HDFC
1111,30-06-2017,1614.95,1625,1606.95,1625,1866235,-17.25,17.25,0,39.4595004,1606.95,1682.2,10.63122924,-89.36877076,16.41160417,22.35169997,-0.015784502,23165080,HDFC
1112,03-07-2017,1621.65,1629,1600.7,1610.35,1518180,6.7,0,6.7,44.18439744,1600.7,1682.2,25.70552147,-74.29447853,14.28042061,20.7374441,-0.019677185,24683260,HDFC
1113,04-07-2017,1640.65,1646.5,1616.4,1626.35,1909048,19,0,19,55.53859061,1600.7,1668,59.36106984,-40.63893016,13.96361958,19.3826792,0.005608336,26592308,HDFC
1114,05-07-2017,1629.1,1640,1622.25,1639.05,1317408,-11.55,11.55,0,48.60360682,1600.7,1667,42.83559578,-57.16440422,12.63491656,18.03312667,0.000522033,25274900,HDFC
1115,06-07-2017,1647.9,1654,1623.05,1623.05,2397552,18.8,0,18.8,58.36720569,1600.7,1667,71.19155354,-28.80844646,12.94963737,17.01642881,-0.003567541,27672452,HDFC
1116,07-07-2017,1629.15,1650,1617,1650,3405664,-18.75,18.75,0,47.89657041,1600.7,1667,42.91101056,-57.08898944,11.55291279,15.9237256,-0.013443546,24266788,HDFC
1117,10-07-2017,1638.85,1678,1620.9,1678,380665,9.7,0,9.7,52.93631395,1600.7,1678,49.35316947,-50.64683053,11.10074495,14.95912947,-0.007389237,24647453,HDFC
1118,11-07-2017,1642.75,1649.1,1629.9,1640.4,1547377,3.9,0,3.9,54.957496,1600.7,1678,54.39844761,-45.60155239,10.93108929,14.15352144,0.008440761,26194830,HDFC
1119,12-07-2017,1639.95,1648,1626.05,1647,2067988,-2.8,2.8,0,53.06948006,1600.7,1678,50.77619664,-49.22380336,10.45023555,13.41286426,0.004748193,24126842,HDFC
1120,13-07-2017,1656.9,1665,1640.2,1640.2,2728741,16.95,0,16.95,62.15157622,1600.7,1678,72.70375162,-27.29624838,11.30654404,12.99160022,0.025976036,26855583,HDFC
1121,14-07-2017,1647.7,1649.9,1637.05,1649,1214121,-9.2,9.2,0,55.433167,1600.7,1678,60.80206986,-39.19793014,11.11468837,12.61621785,0.016063886,25641462,HDFC
1122,17-07-2017,1652.35,1658.9,1645.55,1649,1080487,4.65,0,4.65,58.07611638,1600.7,1678,66.81759379,-33.18240621,11.20865115,12.33470451,0.00713132,26721949,HDFC
1123,18-07-2017,1653,1676.95,1649.1,1655,2073732,0.65,0,0.65,58.47331945,1600.7,1678,67.65847348,-32.34152652,11.20638665,12.10904093,0.014670677,28795681,HDFC
1124,19-07-2017,1654.85,1661,1641.85,1661,2812906,1.85,0,1.85,59.72639674,1600.7,1678,70.05174644,-29.94825356,11.2244827,11.93212929,0.004217489,31608587,HDFC
1125,20-07-2017,1651,1665.15,1642.8,1665.1,1042156,-3.85,3.85,0,55.69111847,1600.7,1678,65.07115136,-34.92884864,10.80362368,11.70642817,0.013411902,30566431,HDFC
1126,21-07-2017,1640.95,1655.7,1622.35,1655.7,2044159,-10.05,10.05,0,46.27437075,1616.4,1678,39.8538961,-60.1461039,9.549063215,11.27495518,0.001281386,28522272,HDFC
1127,24-07-2017,1632.25,1647,1626.3,1646.8,5390510,-8.7,8.7,0,39.58814224,1617,1678,25,-75,7.763307141,10.57262557,-0.006391721,23131762,HDFC
1128,25-07-2017,1632.05,1643,1627.35,1643,2986733,-0.2,0.2,0,39.43699398,1617,1678,24.67213115,-75.32786885,6.259785349,9.710057526,-0.00481722,20145029,HDFC
1129,26-07-2017,1633.45,1643.8,1620,1635,5038801,1.4,0,1.4,41.24875555,1617,1678,26.96721311,-73.03278689,5.122156762,8.792477373,-0.014152936,25183830,HDFC
1130,27-07-2017,1728.2,1743.45,1642.15,1647,9028591,94.75,0,94.75,82.38927992,1620,1743.45,87.64682058,-12.35317942,11.73088471,9.380158841,0.048855981,34212421,HDFC
1131,28-07-2017,1785.35,1799.2,1709.1,1717.5,7936274,57.15,0,57.15,88.15963703,1620,1799.2,92.27120536,-7.728794643,21.33395209,11.77091749,0.080491421,42148695,HDFC
1132,31-07-2017,1789.25,1799.9,1751.2,1783.9,4669583,3.9,0,3.9,88.45743664,1620,1799.9,94.08004447,-5.919955531,28.92571197,15.20187639,0.082425892,46818278,HDFC
1133,01-08-2017,1779.1,1799,1754.7,1787.25,3259641,-10.15,10.15,0,82.24558542,1620,1799.9,88.43802112,-11.56197888,33.73434764,18.90837064,0.075082334,43558637,HDFC
1134,02-08-2017,1766.4,1783.25,1760,1777,1960377,-12.7,12.7,0,74.67471433,1620,1799.9,81.37854364,-18.62145636,36.10425482,22.34754747,0.069897032,41598260,HDFC
1135,03-08-2017,1736.75,1776.8,1725,1774,3975454,-29.65,29.65,0,59.83686464,1620,1799.9,64.89716509,-35.10283491,35.18433304,24.91490459,0.058380816,37622806,HDFC
1136,04-08-2017,1731.35,1738.65,1721,1725.3,5369383,-5.4,5.4,0,57.4384881,1620,1799.9,61.8954975,-38.1045025,33.63186631,26.65829693,0.060713739,32253423,HDFC
1137,07-08-2017,1725.4,1753,1720.1,1731,2372097,-5.95,5.95,0,54.65341284,1620,1799.9,58.5881045,-41.4118955,31.55763321,27.63816419,0.057198003,29881326,HDFC
1138,08-08-2017,1719.9,1732.05,1701,1729.9,2915229,-5.5,5.5,0,51.96592664,1620,1799.9,55.53085047,-44.46914953,29.13414423,27.93736019,0.052924791,26966097,HDFC
1139,09-08-2017,1731.65,1741.8,1705,1718.9,1817847,11.75,0,11.75,57.1588633,1620,1799.9,62.06225681,-37.93774319,27.84070819,27.91802979,0.001996297,28783944,HDFC
1140,10-08-2017,1709.8,1749.05,1699,1728,3177026,-21.85,21.85,0,46.39644646,1620,1799.9,49.91662034,-50.08337966,24.76703941,27.28783172,-0.042316633,25606918,HDFC
1141,11-08-2017,1695.35,1709.45,1681.4,1686.5,1987331,-14.45,14.45,0,40.56774976,1620,1799.9,41.88438021,-58.11561979,20.92394234,26.01505384,-0.052480089,23619587,HDFC
1142,14-08-2017,1713.95,1745.3,1691.3,1700.8,2144672,18.6,0,18.6,49.91325075,1620,1799.9,52.22345748,-47.77654252,19.15828005,24.64369908,-0.036619639,25764259,HDFC
1143,16-08-2017,1741.75,1758,1715.1,1722.8,3357599,27.8,0,27.8,60.59827297,1642.15,1799.9,63.13787639,-36.86212361,19.77426224,23.66981171,-0.013954937,29121858,HDFC
1144,17-08-2017,1759.25,1766,1720.25,1748.75,2408279,17.5,0,17.5,65.88449656,1681.4,1799.9,65.69620253,-34.30379747,21.42753305,23.22135598,0.012955232,31530137,HDFC
1145,18-08-2017,1735.05,1758.75,1725.25,1757,1897962,-24.2,24.2,0,54.26746809,1681.4,1799.9,45.2742616,-54.7257384,20.54815795,22.68671638,0.002137061,29632175,HDFC
1146,21-08-2017,1738.15,1745.4,1730,1737.2,1685595,3.1,0,3.1,55.42907113,1681.4,1799,48.25680272,-51.74319728,19.87231526,22.12383615,0.007389591,31317770,HDFC
1147,22-08-2017,1750.4,1756.75,1737.6,1743.9,1505736,12.25,0,12.25,60.05517443,1681.4,1783.25,67.7466863,-32.2533137,20.09355173,21.71777927,0.017733589,32823506,HDFC
1148,23-08-2017,1765.25,1769,1747.7,1750.25,2858972,14.85,0,14.85,65.11912323,1681.4,1776.8,87.89308176,-12.10691824,21.22251418,21.61872625,0.019403459,35682478,HDFC
1149,24-08-2017,1757.35,1769,1746,1764.6,1560281,-7.9,7.9,0,60.41757786,1681.4,1769,86.70091324,-13.29908676,21.23497748,21.5419765,0.02781027,34122197,HDFC
1150,28-08-2017,1766.45,1784.45,1756.45,1765,4268581,9.1,0,9.1,63.88336273,1681.4,1784.45,82.53275109,-17.46724891,21.72867405,21.57931601,0.041938243,38390778,HDFC
1151,29-08-2017,1727.8,1762.5,1725,1754.5,3262401,-38.65,38.65,0,44.70191517,1681.4,1784.45,45.02668607,-54.97331393,18.78466226,21.02038526,0.008080749,35128377,HDFC
1152,30-08-2017,1759.05,1770,1738.5,1741,2399821,31.25,0,31.25,56.80237579,1681.4,1784.45,75.35177098,-24.64822902,18.75690759,20.56768972,0.009932539,37528198,HDFC
1153,31-08-2017,1776.9,1780.95,1746,1762,4646322,17.85,0,17.85,62.24712573,1681.4,1784.45,92.67345949,-7.326540514,19.94534016,20.44321981,0.010032684,42174520,HDFC
1154,01-09-2017,1759.55,1776,1751.65,1776,2115809,-17.35,17.35,0,54.53766839,1681.4,1784.45,75.83697234,-24.16302766,19.2651054,20.20759693,0.014120631,40058711,HDFC
1155,04-09-2017,1755.4,1768.5,1742.05,1767.8,1660749,-4.15,4.15,0,52.73506367,1691.3,1784.45,68.81374128,-31.18625872,18.18155844,19.80238923,0.009924345,38397962,HDFC
1156,05-09-2017,1767.3,1772.2,1748.05,1754,1287567,11.9,0,11.9,57.39433554,1715.1,1784.45,75.2703677,-24.7296323,18.07471614,19.45685461,0.009654936,39685529,HDFC
1157,06-09-2017,1775,1777,1749.2,1754,1904953,7.7,0,7.7,60.31509625,1720.25,1784.45,85.28037383,-14.71962617,18.39927313,19.24533831,0.005523297,41590482,HDFC
1158,07-09-2017,1781.7,1790.4,1752.1,1773.1,2919242,6.7,0,6.7,62.87061117,1725,1790.4,86.69724771,-13.30275229,18.97835028,19.19194071,0.01385609,44509724,HDFC
1159,08-09-2017,1779.15,1789.85,1774.1,1782,1617395,-2.55,2.55,0,61.14157919,1725,1790.4,82.79816514,-17.20183486,19.0123469,19.15602195,0.007189561,42892329,HDFC
1160,11-09-2017,1781.7,1796,1776.35,1782.5,1803438,2.55,0,2.55,62.33672617,1725,1796,79.85915493,-20.14084507,19.02573631,19.12996482,0.03119574,44695767,HDFC
1161,12-09-2017,1798.1,1802,1768.7,1792.8,2319571,16.4,0,16.4,69.33552195,1725,1802,94.93506494,-5.064935065,20.12767119,19.32950609,0.022199483,47015338,HDFC
1162,13-09-2017,1778.1,1799.7,1773.6,1795,1953168,-20,20,0,54.96360975,1725,1802,68.96103896,-31.03896104,19.16619372,19.29684362,0.000675333,45062170,HDFC
1163,14-09-2017,1771.8,1778.15,1763.05,1777,3630935,-6.3,6.3,0,51.11284258,1725,1802,60.77922078,-39.22077922,17.69191714,18.97585832,0.006962007,41431235,HDFC
1164,15-09-2017,1768.95,1781.3,1758,1761.1,4778170,-2.85,2.85,0,49.30959376,1725,1802,57.07792208,-42.92207792,16.10788943,18.40226455,0.007719038,36653065,HDFC
1165,18-09-2017,1771.75,1779.45,1763.6,1774,1878242,2.8,0,2.8,51.25890843,1738.5,1802,52.36220472,-47.63779528,14.90663821,17.70313928,0.002517965,38531307,HDFC
1166,19-09-2017,1752.6,1776.15,1751,1775.15,2407597,-19.15,19.15,0,39.32498182,1742.05,1802,17.59799833,-82.40200167,12.26797542,16.61610651,-0.012619718,36123710,HDFC
1167,20-09-2017,1767.15,1771,1746,1746,1907381,14.55,0,14.55,49.60991003,1742.05,1802,41.86822352,-58.13177648,11.22152479,15.53719016,-0.008166358,38031091,HDFC
1168,21-09-2017,1788.6,1795.35,1764,1766,4404969,21.45,0,21.45,60.88755715,1742.05,1802,77.64804003,-22.35195997,11.98488656,14.82672944,0.005311525,42436060,HDFC
1169,22-09-2017,1780.95,1786.1,1770.15,1785,2208485,-7.65,7.65,0,55.75277631,1746,1802,62.41071429,-37.58928571,11.8361257,14.22860869,-0.000420946,40227575,HDFC
1170,25-09-2017,1755.05,1777.85,1738.9,1777.8,2021237,-25.9,25.9,0,41.93696019,1738.9,1802,25.59429477,-74.40570523,9.51859368,13.28660569,-0.023941939,38206338,HDFC
1171,26-09-2017,1741.25,1758.8,1728.1,1755,2493262,-13.8,13.8,0,36.39261194,1728.1,1802,17.79431664,-82.20568336,6.493534763,11.9279915,-0.020724369,35713076,HDFC
1172,27-09-2017,1719.35,1757,1715.8,1757,2823110,-21.9,21.9,0,29.29963301,1715.8,1802,4.118329466,-95.88167053,2.302465415,10.00288629,-0.029602664,32889966,HDFC
1173,28-09-2017,1744.35,1764.8,1713,1720.1,3640524,25,0,25,43.74213644,1713,1802,35.2247191,-64.7752809,0.986927146,8.199694459,-0.013906555,36530490,HDFC
1174,29-09-2017,1742.15,1758.7,1730,1749,2811969,-2.2,2.2,0,42.85327231,1713,1802,32.75280899,-67.24719101,-0.230510839,6.513653399,-0.016706646,33718521,HDFC
1175,03-10-2017,1761.6,1768,1734.15,1753.1,3369694,19.45,0,19.45,52.66532031,1713,1799.7,56.05536332,-43.94463668,0.369849838,5.284892687,0.005135228,37088215,HDFC
1176,04-10-2017,1768.1,1777.65,1750,1762.1,2256778,6.5,0,6.5,55.60464452,1713,1795.35,66.90953248,-33.09046752,1.354521595,4.498818469,0.000537589,39344993,HDFC
1177,05-10-2017,1751.7,1776,1748.1,1772.3,1318348,-16.4,16.4,0,47.09151717,1713,1795.35,46.99453552,-53.00546448,0.80228982,3.759512739,-0.020630661,38026645,HDFC
1178,06-10-2017,1740,1765.95,1733.25,1752.2,3033715,-11.7,11.7,0,41.82090124,1713,1795.35,32.78688525,-67.21311475,-0.57284664,2.893040863,-0.022993346,34992930,HDFC
1179,09-10-2017,1749.7,1753.8,1731.2,1739.9,1512781,9.7,0,9.7,47.44749885,1713,1795.35,44.56587735,-55.43412265,-0.869915415,2.140449608,-0.003048346,36505711,HDFC
1180,10-10-2017,1744.75,1749.7,1737.3,1748.55,1956024,-4.95,4.95,0,44.89114526,1713,1795.35,38.55494839,-61.44505161,-1.487619835,1.414835719,0.00201005,34549687,HDFC
1181,11-10-2017,1750.75,1763.4,1741.95,1750,1251359,6,0,6,48.7527856,1713,1795.35,45.84092289,-54.15907711,-1.475990878,0.8366704,0.018262716,35801046,HDFC
1182,12-10-2017,1755.55,1758.8,1742.1,1752.15,1570135,4.8,0,4.8,51.86621043,1713,1786.1,58.20793434,-41.79206566,-1.06715348,0.455905624,0.00642073,37371181,HDFC
1183,13-10-2017,1766.45,1773.8,1752,1752.1,2721949,10.9,0,10.9,58.47616856,1713,1777.85,82.42097147,-17.57902853,0.134837683,0.391692036,0.013948282,40093130,HDFC
1184,16-10-2017,1762.9,1779.4,1746.05,1771,2650209,-3.55,3.55,0,55.60654878,1713,1779.4,75.15060241,-24.84939759,0.791841157,0.47172186,0.000737965,37442921,HDFC
1185,17-10-2017,1759.75,1767.45,1751.3,1760.8,1432658,-3.15,3.15,0,52.94636463,1713,1779.4,70.40662651,-29.59337349,1.046281586,0.586633805,-0.004722584,36010263,HDFC
1186,18-10-2017,1751.55,1764.2,1749,1759.75,1747083,-8.2,8.2,0,46.29419251,1713,1779.4,58.05722892,-41.94277108,0.579575009,0.585222046,-8.56E-05,34263180,HDFC
1187,19-10-2017,1745.75,1754.75,1738.9,1751,119832,-5.8,5.8,0,41.98870925,1730,1779.4,31.88259109,-68.11740891,-0.255361198,0.417105397,0.003304598,34143348,HDFC
1188,23-10-2017,1722.4,1751.8,1713,1751.8,2813675,-23.35,23.35,0,29.3213487,1713,1779.4,14.15662651,-85.84337349,-2.76928146,-0.220171974,-0.015602675,31329673,HDFC
1189,24-10-2017,1722.3,1732,1712,1725,1561822,-0.1,0.1,0,29.27770198,1712,1779.4,15.28189911,-84.71810089,-4.715295552,-1.11919669,-0.012867173,29767851,HDFC
1190,25-10-2017,1677.65,1737.9,1649.35,1736.9,3823429,-44.65,44.65,0,16.57012371,1649.35,1779.4,21.76086121,-78.23913879,-9.748038268,-2.844965005,-0.041753534,25944422,HDFC
1191,26-10-2017,1692.35,1707,1638,1669.5,6425264,14.7,0,14.7,28.37903253,1638,1779.4,38.43705799,-61.56294201,-12.40733198,-4.757438401,-0.036000114,32369686,HDFC
1192,27-10-2017,1699.05,1716,1681.35,1704,1217140,6.7,0,6.7,33.34098326,1638,1779.4,43.17538897,-56.82461103,-13.81495718,-6.568942156,-0.038155623,33586826,HDFC
1193,30-10-2017,1705.8,1722.8,1685.1,1706.4,2705599,6.75,0,6.75,38.30929538,1638,1779.4,47.94908062,-52.05091938,-14.22190048,-8.099533821,-0.032389812,36292425,HDFC
1194,31-10-2017,1707.4,1727.8,1697.95,1711,2287919,1.6,0,1.6,39.54174644,1638,1779.4,49.08062235,-50.91937765,-14.25102244,-9.329831544,-0.029748544,38580344,HDFC
1195,01-11-2017,1754.3,1760.1,1701.25,1710,3406418,46.9,0,46.9,63.92049102,1638,1779.4,82.24893918,-17.75106082,-10.37012343,-9.537889922,0.001570038,41986762,HDFC
1196,02-11-2017,1762.25,1769.85,1743.1,1743.1,2386293,7.95,0,7.95,66.55797877,1638,1779.4,87.87128713,-12.12871287,-6.577166961,-8.94574533,0.009451525,44373055,HDFC
1197,03-11-2017,1776.3,1790,1760.15,1771,1614278,14.05,0,14.05,70.89641678,1638,1790,90.98684211,-9.013157895,-2.409726229,-7.63854151,0.031293544,45987333,HDFC
1198,06-11-2017,1790.2,1799,1766,1770,1465290,13.9,0,13.9,74.65044551,1638,1799,94.53416149,-5.465838509,1.99165584,-5.71250204,0.039424026,47452623,HDFC
1199,07-11-2017,1764.65,1804,1760.25,1783.6,2261156,-25.55,25.55,0,58.61491651,1638,1804,76.29518072,-23.70481928,3.379158534,-3.894169925,0.051858254,45191467,HDFC
1200,08-11-2017,1747.45,1777.95,1742.25,1758.2,2713933,-17.2,17.2,0,50.2332957,1638,1804,65.93373494,-34.06626506,3.055644593,-2.504207021,0.032558277,42477534,HDFC
1201,09-11-2017,1725.85,1760,1706,1760,3596933,-21.6,21.6,0,41.61135671,1638,1804,52.92168675,-47.07831325,1.044280171,-1.794509583,0.01577352,38880601,HDFC
1202,10-11-2017,1709.5,1726,1697.15,1726,2331920,-16.35,16.35,0,36.1866793,1638,1804,43.07228916,-56.92771084,-1.847749278,-1.805157522,0.00216907,36548681,HDFC
1203,13-11-2017,1670.3,1705,1666.4,1700.1,3835863,-39.2,39.2,0,26.59526614,1638,1804,19.45783133,-80.54216867,-7.219592872,-2.888044592,-0.021728945,32712818,HDFC
1204,14-11-2017,1661.4,1682.55,1658,1664,3488363,-8.9,8.9,0,24.86849339,1638,1804,14.09638554,-85.90361446,-12.05599919,-4.721635511,-0.052955595,29224455,HDFC
1205,15-11-2017,1650.9,1676.4,1648.4,1663,2688079,-10.5,10.5,0,22.84898799,1648.4,1804,1.606683805,-98.3933162,-16.54542295,-7.086392999,-0.063186268,26536376,HDFC
1206,16-11-2017,1664.4,1672,1649.3,1660,4085012,13.5,0,13.5,31.1442163,1648.4,1804,10.28277635,-89.71722365,-18.79730284,-9.428574968,-0.062996116,30621388,HDFC
1207,17-11-2017,1705.5,1720,1688.3,1694,4157219,41.1,0,41.1,50.02107065,1648.4,1804,36.6966581,-63.3033419,-17.06874945,-10.95660986,-0.047313149,34778607,HDFC
1208,20-11-2017,1689.2,1706.75,1685,1699.9,3406045,-16.3,16.3,0,44.44525632,1648.4,1804,26.22107969,-73.77892031,-16.82023896,-12.12933568,-0.042756354,31372562,HDFC
1209,21-11-2017,1694.5,1706,1687,1692.9,3626597,5.3,0,5.3,46.67533225,1648.4,1804,29.62724936,-70.37275064,-16.01106136,-12.90568082,-0.030301296,34999159,HDFC
1210,22-11-2017,1718.15,1724.95,1692.75,1694.5,3096864,23.65,0,23.65,55.80883102,1648.4,1804,44.82647815,-55.17352185,-13.30801837,-12.98614833,-0.00446157,38096023,HDFC
1211,23-11-2017,1704.6,1720.95,1700.65,1715,1891748,-13.55,13.55,0,50.13230367,1648.4,1804,36.11825193,-63.88174807,-12.11950301,-12.81281927,-0.002866335,36204275,HDFC
1212,24-11-2017,1711.05,1715,1697.1,1707.9,1269395,6.45,0,6.45,52.77081283,1648.4,1804,40.26349614,-59.73650386,-10.53568609,-12.35739263,0.024396815,37473670,HDFC
1213,27-11-2017,1711,1714.55,1699.6,1709,1160941,-0.05,0.05,0,52.74585046,1648.4,1777.95,48.32111154,-51.67888846,-9.178727695,-11.72165964,0.02985434,36312729,HDFC
1214,28-11-2017,1725.5,1737,1710,1713.2,2024236,14.5,0,14.5,59.20332479,1648.4,1760,69.08602151,-30.91397849,-6.854287612,-10.74818524,0.045187473,38336965,HDFC
1215,29-11-2017,1704.15,1727.1,1700.35,1727.1,5140571,-21.35,21.35,0,48.04813308,1648.4,1737,62.92325056,-37.07674944,-6.658167459,-9.930181681,0.02388248,33196394,HDFC
1216,30-11-2017,1675.7,1703.85,1667.95,1702,6832920,-28.45,28.45,0,37.25499469,1648.4,1737,30.81264108,-69.18735892,-8.698151187,-9.683775582,-0.017472882,26363474,HDFC
1217,01-12-2017,1658.8,1685.75,1651.05,1684.2,2269479,-16.9,16.9,0,32.28432128,1648.4,1737,11.73814898,-88.26185102,-11.54545295,-10.05611106,-0.017996685,24093995,HDFC
1218,04-12-2017,1680.4,1685,1655.6,1664.9,3197224,21.6,0,21.6,43.41768482,1648.4,1737,36.11738149,-63.88261851,-11.9215959,-10.42920803,-0.008321039,27291219,HDFC
1219,05-12-2017,1679.5,1690,1663.4,1677,2444540,-0.9,0.9,0,43.07718169,1649.3,1737,34.43557583,-65.56442417,-12.15223102,-10.77381262,-0.022495126,24846679,HDFC
1220,06-12-2017,1648.4,1675.4,1640.85,1673.05,3917846,-31.1,31.1,0,32.81584716,1640.85,1737,7.852314093,-92.14768591,-14.67535277,-11.55412065,-0.032969612,20928833,HDFC
1221,07-12-2017,1655.55,1660,1644.1,1650,2212536,7.15,0,7.15,36.80890849,1640.85,1737,15.28861154,-84.71138846,-15.9145467,-12.42620586,-0.032436223,23141369,HDFC
1222,08-12-2017,1682.95,1688.1,1660,1665,3673846,27.4,0,27.4,49.95968982,1640.85,1737,43.78575143,-56.21424857,-14.51830779,-12.84462625,-0.016393922,26815215,HDFC
1223,11-12-2017,1709.95,1718,1691,1692,2775331,27,0,27,59.53470584,1640.85,1737,71.86687467,-28.13312533,-11.10509147,-12.49671929,-0.009011881,29590546,HDFC
1224,12-12-2017,1710.8,1715,1698,1707.1,3650373,0.85,0,0.85,59.81402268,1640.85,1737,72.75091004,-27.24908996,-8.236559115,-11.64468726,0.003902239,33240919,HDFC
1225,13-12-2017,1696.7,1716.65,1688.3,1709.1,2176285,-14.1,14.1,0,52.83372786,1640.85,1737,58.08632345,-41.91367655,-7.020055886,-10.71976098,0.012532076,31064634,HDFC
1226,14-12-2017,1704.5,1710,1682.25,1705,1996271,7.8,0,7.8,56.10354594,1640.85,1737,66.19864795,-33.80135205,-5.364732208,-9.648755227,0.027550036,33060905,HDFC
1227,15-12-2017,1723,1734.55,1713.05,1714,2987009,18.5,0,18.5,63.10359555,1640.85,1737,85.43941758,-14.56058242,-2.530906166,-8.225185415,0.025351107,36047914,HDFC
1228,18-12-2017,1719.95,1741.3,1679.7,1713.1,2221752,-3.05,3.05,0,61.24569168,1640.85,1741.3,78.7456446,-21.2543554,-0.525134696,-6.685175271,0.024084549,33826162,HDFC
1229,19-12-2017,1709.15,1725,1704.65,1722,2431117,-10.8,10.8,0,54.66934327,1640.85,1741.3,67.99402688,-32.00597312,0.190784658,-5.309983285,0.036853919,31395045,HDFC
1230,20-12-2017,1693.7,1718.35,1690,1715.95,2487331,-15.45,15.45,0,46.43856831,1640.85,1741.3,52.61324042,-47.38675958,-0.482962682,-4.344579165,0.023043701,28907714,HDFC
1231,21-12-2017,1701.9,1710,1695.25,1710,1712824,8.2,0,8.2,50.96004417,1640.85,1741.3,60.77650572,-39.22349428,-0.351192505,-3.545901833,0.01125999,30620538,HDFC
1232,22-12-2017,1709.35,1717,1697,1708.9,1827617,7.45,0,7.45,54.94700554,1640.85,1741.3,68.19313091,-31.80686909,0.350350426,-2.766651381,-0.000350887,32448155,HDFC
1233,26-12-2017,1713.2,1719,1702.05,1715,1367535,3.85,0,3.85,57.03009863,1640.85,1741.3,72.02588352,-27.97411648,1.203122233,-1.972696658,0.001402852,33815690,HDFC
1234,27-12-2017,1707.9,1715,1705,1710,987445,-5.3,5.3,0,53.12822358,1644.1,1741.3,65.63786008,-34.36213992,1.434745475,-1.291208232,0.006601049,32828245,HDFC
1235,28-12-2017,1696.15,1715,1690.3,1713.75,1150023,-11.75,11.75,0,45.21487226,1660,1741.3,44.46494465,-55.53505535,0.662544363,-0.900457713,-0.004898797,31678222,HDFC
1236,29-12-2017,1710.4,1713,1697.55,1699,2178686,14.25,0,14.25,54.66420771,1679.7,1741.3,49.83766234,-50.16233766,1.186745265,-0.483017117,-0.007312826,33856908,HDFC
1237,01-01-2018,1683.75,1711.05,1677.5,1710,1387222,-26.65,26.65,0,39.83709708,1677.5,1741.3,9.796238245,-90.20376176,-0.54200611,-0.494814916,-0.021047123,32469686,HDFC
1238,02-01-2018,1703.25,1706.25,1685.4,1690,1468475,19.5,0,19.5,51.04734098,1677.5,1741.3,40.36050157,-59.63949843,-0.334708685,-0.46279367,-0.003452008,33938161,HDFC
1239,03-01-2018,1700.8,1711.8,1695,1705.2,2133332,-2.45,2.45,0,49.70469032,1677.5,1741.3,36.52037618,-63.47962382,-0.363923425,-0.443019621,0.004192006,31804829,HDFC
1240,04-01-2018,1703.2,1708.95,1691.05,1708.95,1585554,2.4,0,2.4,51.15675993,1677.5,1741.3,40.28213166,-59.71786834,-0.191212198,-0.392658136,0.000763852,33390383,HDFC
1241,05-01-2018,1725.2,1731,1705.85,1716,2302884,22,0,22,62.58269594,1677.5,1741.3,74.76489028,-25.23510972,1.701267676,0.026127026,0.00927253,35693267,HDFC
1242,08-01-2018,1740.95,1745,1729,1729.25,2997037,15.75,0,15.75,68.64221884,1677.5,1745,94,-6,4.42100242,0.905102105,0.016197759,38690304,HDFC
1243,09-01-2018,1735.05,1748.35,1725,1743.85,1470161,-5.9,5.9,0,64.15172952,1677.5,1748.35,81.22794637,-18.77205363,6.030811664,1.930244017,0.015896715,37220143,HDFC
1244,10-01-2018,1726.45,1739.5,1721.2,1730,1465727,-8.6,8.6,0,57.79297906,1677.5,1748.35,69.08962597,-30.91037403,6.537291138,2.851653441,0.017863986,35754416,HDFC
1245,11-01-2018,1741.35,1745,1724.4,1729.9,1680803,14.9,0,14.9,64.7732424,1677.5,1748.35,90.11997177,-9.880028229,8.048210485,3.89096485,0.018095182,37435219,HDFC
1246,12-01-2018,1760.95,1764.95,1740.6,1744,3280043,19.6,0,19.6,71.84152556,1677.5,1764.95,95.42595769,-4.57404231,10.70379447,5.253530774,0.045850037,40715262,HDFC
1247,15-01-2018,1871.2,1886.8,1778.05,1790,9486397,110.25,0,110.25,87.76942615,1677.5,1886.8,92.54658385,-7.453416149,21.45727144,8.494278908,0.098605607,50201659,HDFC
1248,16-01-2018,1845.95,1870,1835.75,1870,5373079,-25.25,25.25,0,76.35583443,1677.5,1886.8,80.48256092,-19.51743908,27.62358792,12.32014071,0.085342192,44828580,HDFC
1249,17-01-2018,1858.35,1869,1841,1841,3622589,12.4,0,12.4,77.97851796,1677.5,1886.8,86.40707119,-13.59292881,33.12912261,16.48193709,0.091093236,48451169,HDFC
1250,18-01-2018,1896.8,1918.65,1865.6,1875.45,6605642,38.45,0,38.45,82.31981262,1677.5,1918.65,90.93924943,-9.06075057,40.13227233,21.21200414,0.099466728,55056811,HDFC
1251,19-01-2018,1901.25,1912.8,1894.35,1897,2833442,4.45,0,4.45,82.77332155,1685.4,1918.65,92.54019293,-7.459807074,45.51670847,26.072945,0.092076165,57890253,HDFC
1252,22-01-2018,1872,1924.35,1863.95,1901,3649174,-29.25,29.25,0,69.29295174,1691.05,1924.35,77.56108015,-22.43891985,46.88324152,30.23500431,0.078931443,54241079,HDFC
1253,23-01-2018,1884.65,1896.9,1870.2,1874,2158639,12.65,0,12.65,71.60091226,1691.05,1924.35,82.98328333,-17.01671667,48.42872193,33.87374783,0.09163312,56399718,HDFC
1254,24-01-2018,1911.2,1919.55,1880,1886.6,3401495,26.55,0,26.55,75.97404678,1705.85,1924.35,93.98169336,-6.018306636,51.20562286,37.34012284,0.097539266,59801213,HDFC
1255,25-01-2018,1908.3,1922.5,1883.5,1917,4622281,-2.9,2.9,0,74.52765063,1721.2,1924.35,92.09943392,-7.900566084,52.5663786,40.38537399,0.083676425,55178932,HDFC
1256,29-01-2018,1967.6,1986.05,1909.9,1915,6305147,59.3,0,59.3,82.42300001,1721.2,1986.05,93.03379271,-6.966207287,57.76393505,43.8610862,0.051517743,61484079,HDFC
1257,30-01-2018,1937.5,1971.5,1927.9,1971.5,4066082,-30.1,30.1,0,69.75921217,1721.2,1986.05,81.66886917,-18.33113083,58.77667659,46.84420428,0.049595059,57417997,HDFC
1258,31-01-2018,1956.3,1963.05,1918,1932.25,3665385,18.8,0,18.8,72.77388472,1724.4,1986.05,88.62984903,-11.37015097,60.40003049,49.55536952,0.052708047,61083382,HDFC
1259,01-02-2018,1967.55,1975.3,1931.8,1963,3838192,11.25,0,11.25,74.52722378,1740.6,1986.05,92.46282339,-7.537176614,61.88100543,52.0204967,0.037299663,64921574,HDFC
1260,02-02-2018,1903.85,1946,1895,1946,3272591,-63.7,63.7,0,52.45657944,1778.05,1986.05,60.48076923,-39.51923077,57.25463529,53.06732442,0.001367521,61648983,HDFC
1261,05-02-2018,1823.35,1886,1811.8,1866.1,6082208,-80.5,80.5,0,36.63625218,1811.8,1986.05,6.628407461,-93.37159254,46.55585943,51.76503142,-0.025988248,55566775,HDFC
1262,06-02-2018,1788.6,1808.8,1757.05,1769,3601190,-34.75,34.75,0,31.85156924,1757.05,1986.05,13.77729258,-86.22270742,34.87099676,48.38622449,-0.05096437,51965585,HDFC
1263,07-02-2018,1785.35,1806.65,1767.05,1795,3549234,-3.25,3.25,0,31.40890807,1757.05,1986.05,12.3580786,-87.6419214,25.05954028,43.72088765,-0.065848681,48416351,HDFC
1264,08-02-2018,1811.8,1836.4,1787.5,1788,1865933,26.45,0,26.45,39.32709257,1757.05,1986.05,23.90829694,-76.09170306,19.19689444,38.81608901,-0.050568569,50282284,HDFC
1265,09-02-2018,1773.05,1783.45,1762,1780.25,2773971,-38.75,38.75,0,32.90577732,1757.05,1986.05,6.986899563,-93.01310044,11.29371727,33.31161466,-0.098876804,47508313,HDFC
1266,12-02-2018,1805.45,1812.3,1760.7,1777.1,3194895,32.4,0,32.4,42.03655105,1757.05,1986.05,21.13537118,-78.86462882,7.557681401,28.16082801,-0.068154839,50703208,HDFC
1267,14-02-2018,1814,1833,1805,1820,3923887,8.55,0,8.55,44.34283383,1757.05,1986.05,24.86899563,-75.13100437,5.226511631,23.57396473,-0.072739355,54627095,HDFC
1268,15-02-2018,1829.5,1851,1819.15,1828.9,3382968,15.5,0,15.5,48.61918004,1757.05,1986.05,31.63755459,-68.36244541,4.577002419,19.77457227,-0.070163401,58010063,HDFC
1269,16-02-2018,1815.5,1836.95,1804.2,1835.5,2368880,-14,14,0,45.01464047,1757.05,1986.05,25.52401747,-74.47598253,2.899158991,16.39948961,-0.046405967,55641183,HDFC
1270,19-02-2018,1814.05,1830.2,1801,1827.75,1603737,-1.45,1.45,0,44.61931667,1757.05,1975.3,26.11683849,-73.88316151,1.435900933,13.40677188,-0.005100502,54037446,HDFC
1271,20-02-2018,1811.75,1840,1802.5,1832.9,2523482,-2.3,2.3,0,43.91347912,1757.05,1975.3,25.06300115,-74.93699885,0.089634352,10.74334437,0.012943084,51513964,HDFC
1272,21-02-2018,1824.8,1832.7,1816,1825,3795216,13.05,0,13.05,49.17696015,1757.05,1975.3,31.04238259,-68.95761741,0.074871255,8.609649749,0.022096508,55309180,HDFC
1273,22-02-2018,1819.25,1825,1807.7,1819.7,6229874,-5.55,5.55,0,47.01198209,1757.05,1946,32.91876158,-67.08123842,-0.38028355,6.811663089,0.004111933,49079306,HDFC
1274,23-02-2018,1824.2,1827.4,1815.5,1826.85,2023292,4.95,0,4.95,49.30858726,1757.05,1886,52.07444746,-47.92555254,-0.337680807,5.38179431,0.028848594,51102598,HDFC
1275,26-02-2018,1843.25,1852.75,1821.35,1830,2253522,19.05,0,19.05,57.49014463,1757.05,1852.75,90.07314525,-9.926854754,1.219203744,4.549276197,0.020936609,53356120,HDFC
1276,27-02-2018,1828.65,1851,1819.05,1850,2558313,-14.6,14.6,0,50.30958776,1760.7,1852.75,73.81857686,-26.18142314,1.260418663,3.89150469,0.008076075,50797807,HDFC
1277,28-02-2018,1808.7,1832,1803.6,1830,2802070,-19.95,19.95,0,42.03233539,1760.7,1852.75,52.14557306,-47.85442694,-0.313107183,3.050582316,-0.011369227,47995737,HDFC
1278,01-03-2018,1814.15,1818.5,1801,1811,3272003,5.45,0,5.45,44.89035097,1760.7,1852.75,58.06626833,-41.93373167,-1.10760057,2.218945739,-0.000743597,51267740,HDFC
1279,05-03-2018,1789.6,1814,1780.3,1814,2163209,-24.55,24.55,0,35.73331371,1760.7,1852.75,31.39598045,-68.60401955,-3.675849228,1.039986745,-0.013478129,49104531,HDFC
1280,06-03-2018,1782.8,1819,1758.1,1803.9,2899309,-6.8,6.8,0,33.54629799,1758.1,1852.75,26.09614369,-73.90385631,-6.188569981,-0.4057246,-0.015979026,46205222,HDFC
1281,07-03-2018,1761.75,1782.2,1756.1,1774.35,1624922,-21.05,21.05,0,27.52833343,1756.1,1852.75,5.845835489,-94.15416451,-9.765903107,-2.277760301,-0.034551732,44580300,HDFC
1282,08-03-2018,1798.75,1803.55,1771.7,1772.9,3174098,37,0,37,46.86178901,1756.1,1852.75,44.12829798,-55.87170202,-9.505797685,-3.723367778,-0.01126838,47754398,HDFC
1283,09-03-2018,1818.6,1834.3,1801,1801,3000976,19.85,0,19.85,54.39321762,1756.1,1852.75,64.66632178,-35.33367822,-7.610207424,-4.500735707,-0.003069839,50755374,HDFC
1284,12-03-2018,1858.05,1865.35,1827.05,1831.6,3242604,39.45,0,39.45,65.5802044,1756.1,1865.35,93.3180778,-6.681922197,-2.891323802,-4.178853326,0.008029296,53997978,HDFC
1285,13-03-2018,1868.5,1881.5,1850,1850,3264920,10.45,0,10.45,67.98076068,1756.1,1881.5,89.63317384,-10.36682616,1.672375034,-3.008607654,0.021792032,57262898,HDFC
1286,14-03-2018,1844.7,1863.8,1836.05,1857.25,1649636,-23.8,23.8,0,57.45117888,1756.1,1881.5,70.6539075,-29.3460925,3.330288651,-1.740828393,0.019903798,55613262,HDFC
1287,15-03-2018,1830,1847.7,1827.4,1846,1548960,-14.7,14.7,0,51.73983362,1756.1,1881.5,58.93141946,-41.06858054,3.418622242,-0.708938266,0.008736874,54064302,HDFC
1288,16-03-2018,1791.4,1832,1784.65,1830,8008654,-38.6,38.6,0,39.76311712,1756.1,1881.5,28.14992026,-71.85007974,0.369668533,-0.493216906,0.001005811,46055648,HDFC
1289,19-03-2018,1774.5,1806.85,1768.45,1799,3986719,-16.9,16.9,0,35.60007366,1756.1,1881.5,14.67304625,-85.32695375,-3.371473757,-1.068868276,-0.004655598,42068929,HDFC
1290,20-03-2018,1800.05,1808.5,1771,1771,3441458,25.55,0,25.55,45.54536443,1756.1,1881.5,35.04784689,-64.95215311,-4.225970153,-1.700288652,0.021739747,45510387,HDFC
1291,21-03-2018,1817.85,1830.4,1803.6,1820,3574861,17.8,0,17.8,51.55881663,1756.1,1881.5,49.24242424,-50.75757576,-3.427345162,-2.045699954,0.010618485,49085248,HDFC
1292,22-03-2018,1809.55,1838.5,1801.75,1820,2664935,-8.3,8.3,0,48.66725875,1756.1,1881.5,42.62360447,-57.37639553,-3.424692019,-2.321498367,-0.004976355,46420313,HDFC
1293,23-03-2018,1789.6,1799.55,1776.1,1787.7,2788553,-19.95,19.95,0,42.1164696,1756.1,1881.5,26.71451356,-73.28548644,-4.975038508,-2.852206395,-0.036839698,43631760,HDFC
1294,26-03-2018,1830.15,1835.35,1778.25,1781,1922453,40.55,0,40.55,56.00499101,1756.1,1881.5,59.05103668,-40.94896332,-2.898244008,-2.861413917,-0.020524485,45554213,HDFC
1295,27-03-2018,1823.15,1838,1813.9,1837.9,3597668,-7,7,0,53.45048045,1768.45,1881.5,48.38567006,-51.61432994,-1.796501946,-2.648431523,-0.011682116,41956545,HDFC
1296,28-03-2018,1825.6,1830.95,1812.75,1821,4010323,2.45,0,2.45,54.29242807,1768.45,1881.5,50.55285272,-49.44714728,-0.717399169,-2.262225052,-0.002404372,45966868,HDFC
1297,02-04-2018,1838.05,1854.15,1828.95,1830.95,2607397,12.45,0,12.45,58.67504428,1768.45,1881.5,61.5656789,-38.4343211,1.129389607,-1.583902121,0.026041085,48574265,HDFC
1298,03-04-2018,1825.7,1846.55,1815.6,1836,1950749,-12.35,12.35,0,52.87247369,1768.45,1881.5,50.64130916,-49.35869084,1.578248168,-0.951472063,0.028853198,46623516,HDFC
1299,04-04-2018,1803.3,1831.8,1792,1830.7,2268911,-22.4,22.4,0,43.80615278,1768.45,1863.8,36.54955427,-63.45044573,0.12503766,-0.736170118,0.001805505,44354605,HDFC
1300,05-04-2018,1824.45,1830,1812.2,1821,3549233,21.15,0,21.15,52.65155247,1768.45,1854.15,65.34422404,-34.65577596,0.672236975,-0.4544887,0.003630663,47903838,HDFC
1301,06-04-2018,1829,1837.8,1820.6,1827,3260963,4.55,0,4.55,54.4320332,1768.45,1854.15,70.65344224,-29.34655776,1.45625653,-0.072339654,0.010748529,51164801,HDFC
1302,09-04-2018,1836.7,1847,1825,1834.85,1480293,7.7,0,7.7,57.54909707,1768.45,1854.15,79.63827305,-20.36172695,2.668166363,0.475761549,0.02631873,52645094,HDFC
1303,10-04-2018,1817.5,1851.65,1815.1,1848,1673162,-19.2,19.2,0,48.08545711,1771,1854.15,55.92303067,-44.07696933,2.055637983,0.791736836,-0.006912002,50971932,HDFC
1304,11-04-2018,1812.4,1827.8,1802.6,1823.5,1917617,-5.1,5.1,0,45.77820369,1776.1,1854.15,46.5086483,-53.4913517,1.14547315,0.862484099,-0.005896388,49054315,HDFC
1305,12-04-2018,1829.05,1830.55,1806,1808.45,1296216,16.65,0,16.65,54.07843503,1776.1,1854.15,67.84112748,-32.15887252,1.747532348,1.039493749,0.00188979,50350531,HDFC
1306,13-04-2018,1840.6,1842.85,1822.6,1834,1849910,11.55,0,11.55,59.09090538,1776.1,1854.15,82.63933376,-17.36066624,3.120683772,1.455731753,0.00138734,52200441,HDFC
1307,16-04-2018,1870.45,1873,1832.2,1833,2555945,29.85,0,29.85,69.13676038,1778.25,1873,97.30870712,-2.691292876,6.542147893,2.473014981,0.024511146,54756386,HDFC
1308,17-04-2018,1889.7,1896.65,1862.2,1875,2842835,19.25,0,19.25,73.9050053,1792,1896.65,93.3588151,-6.641184902,10.68384032,4.115180049,0.047912161,57599221,HDFC
1309,18-04-2018,1877.7,1898,1871.1,1897.7,1690874,-12,12,0,66.51361684,1792,1898,80.8490566,-19.1509434,12.84973792,5.862091622,0.029186878,55908347,HDFC
1310,19-04-2018,1858.65,1887.05,1851.65,1883,1655535,-19.05,19.05,0,56.21525792,1792,1898,62.87735849,-37.12264151,12.88057235,7.265787768,0.016211044,54252812,HDFC
1311,20-04-2018,1834.15,1873,1832.5,1863,2627245,-24.5,24.5,0,45.71234094,1792,1898,39.76415094,-60.23584906,10.80352728,7.973335671,-0.00138836,51625567,HDFC
1312,23-04-2018,1830.85,1849,1828.6,1849,2514450,-3.3,3.3,0,44.42244711,1792,1898,36.6509434,-63.3490566,8.789847786,8.136638094,0.007345254,49111117,HDFC
1313,24-04-2018,1859.55,1867.5,1834.5,1836.9,2381491,28.7,0,28.7,56.6870641,1802.6,1898,59.69601677,-40.30398323,9.401468149,8.389604105,0.026015228,51492608,HDFC
1314,25-04-2018,1849.5,1858,1840,1858,1299220,-10.05,10.05,0,52.04642745,1802.6,1898,49.16142558,-50.83857442,8.971809252,8.506045134,0.011180668,50193388,HDFC
1315,26-04-2018,1850.45,1857.35,1841.2,1853,3349024,0.95,0,0.95,52.47081189,1802.6,1898,50.1572327,-49.8427673,8.608722546,8.526580617,0.005351516,53542412,HDFC
1316,27-04-2018,1853.75,1859.35,1840,1848.1,3005770,3.3,0,3.3,54.09897932,1802.6,1898,53.6163522,-46.3836478,8.489395668,8.519143627,-0.008928333,56548182,HDFC
1317,30-04-2018,1883.25,1891.55,1862.55,1864,3343611,29.5,0,29.5,66.08319436,1802.6,1898,84.53878407,-15.46121593,10.65243705,8.945802312,-0.00341324,59891793,HDFC
1318,02-05-2018,1910.6,1912.5,1871.35,1897,4812147,27.35,0,27.35,73.48799066,1806,1912.5,98.21596244,-1.784037559,14.40749868,10.03814159,0.017521436,64703940,HDFC
1319,03-05-2018,1922.7,1931.65,1906.75,1908,4558083,12.1,0,12.1,76.14643413,1822.6,1931.65,91.79275562,-8.207244383,18.15055268,11.66062381,0.034460496,69262023,HDFC
1320,04-05-2018,1910.35,1933.8,1904.2,1929,1990972,-12.35,12.35,0,68.10401013,1828.6,1933.8,77.70912548,-22.29087452,19.89111576,13.3067222,0.04154513,67271051,HDFC
1321,07-05-2018,1918.7,1922.1,1901.25,1914,2389766,8.35,0,8.35,70.53204448,1828.6,1933.8,85.64638783,-14.35361217,21.69422226,14.98422221,0.047983177,69660817,HDFC
1322,08-05-2018,1903.35,1920.1,1895.6,1920.1,2124127,-15.35,15.35,0,60.72659547,1828.6,1933.8,71.05513308,-28.94486692,21.63518351,16.31441447,0.023554086,67536690,HDFC
1323,09-05-2018,1897.65,1905.4,1882.3,1893.15,1669898,-5.7,5.7,0,57.31272935,1828.6,1933.8,65.63688213,-34.36311787,20.88767243,17.22906606,0.026034063,65866792,HDFC
1324,10-05-2018,1894.3,1909.95,1890.45,1908,1153192,-3.35,3.35,0,55.20804123,1828.6,1933.8,62.45247148,-37.54752852,19.79674298,17.74260144,0.023696939,64713600,HDFC
1325,11-05-2018,1919.8,1921.7,1901,1901,948291,25.5,0,25.5,66.13179911,1828.6,1933.8,86.69201521,-13.30798479,20.7506103,18.34420321,0.035630479,65661891,HDFC
1326,14-05-2018,1930.6,1936.9,1919.8,1919.8,1936219,10.8,0,10.8,69.73837992,1834.5,1936.9,93.84765625,-6.15234375,22.12300651,19.09996387,0.025142705,67598110,HDFC
1327,15-05-2018,1929.55,1941.9,1923.8,1936.5,2873050,-1.05,1.05,0,68.91513023,1840,1941.9,87.88027478,-12.11972522,22.86237099,19.8524453,0.00991835,64725060,HDFC
1328,16-05-2018,1914.55,1929,1908.9,1924.9,1366048,-15,15,0,57.68959463,1840,1941.9,73.15996075,-26.84003925,21.98452412,20.27886106,-0.004238831,63359012,HDFC
1329,17-05-2018,1875.1,1919,1867.95,1919,2751107,-39.45,39.45,0,38.60627144,1840,1941.9,34.44553484,-65.55446516,17.89920792,19.80293043,-0.018452116,60607905,HDFC
1330,18-05-2018,1853,1882.1,1850.05,1870,2517918,-22.1,22.1,0,31.80558077,1850.05,1941.9,3.211758302,-96.7882417,12.73151907,18.38864816,-0.034241935,58089987,HDFC
1331,21-05-2018,1819.2,1860,1816.5,1860,2816934,-33.8,33.8,0,24.26310568,1816.5,1941.9,2.153110048,-97.84688995,5.84137517,15.87919356,-0.044211522,55273053,HDFC
1332,22-05-2018,1810,1829,1795.85,1820.2,3151951,-9.2,9.2,0,22.58129022,1795.85,1941.9,9.688462855,-90.31153714,-0.357357234,12.6318834,-0.046188707,52121102,HDFC
1333,23-05-2018,1783.65,1807.4,1780.05,1807.4,3059058,-26.35,26.35,0,18.3726291,1780.05,1941.9,2.224281742,-97.77571826,-7.311835817,8.64313956,-0.058412078,49062044,HDFC
1334,24-05-2018,1806.1,1814.05,1788.1,1797,2185202,22.45,0,22.45,31.01266251,1780.05,1941.9,16.09514983,-83.90485017,-10.88629242,4.737253165,-0.059224919,51247246,HDFC
1335,25-05-2018,1819.75,1828.65,1796.05,1808.2,2301042,13.65,0,13.65,37.77281905,1780.05,1941.9,24.52888477,-75.47111523,-12.4738434,1.295033851,-0.057417383,53548288,HDFC
1336,28-05-2018,1829.55,1835,1820.55,1825,1616546,9.8,0,9.8,42.44492142,1780.05,1941.9,30.58387396,-69.41612604,-12.79373271,-1.522719461,-0.051825555,55164834,HDFC
1337,29-05-2018,1809.75,1828.75,1804.3,1827.75,1160204,-19.8,19.8,0,36.12233145,1780.05,1941.9,18.35032437,-81.64967563,-14.47804789,-4.113785147,-0.054738711,54004630,HDFC
1338,30-05-2018,1790.8,1807,1780.4,1804,3140621,-18.95,18.95,0,31.01965351,1780.05,1941.9,6.641952425,-93.35804757,-17.14435696,-6.71989951,-0.044957602,50864009,HDFC
1339,31-05-2018,1833,1838.5,1797.2,1812,5622276,42.2,0,42.2,49.38976779,1780.05,1941.9,32.71547729,-67.28452271,-15.6715865,-8.510236907,-0.010793308,56486285,HDFC
1340,01-06-2018,1844.25,1857,1823.95,1833,2653497,11.25,0,11.25,53.22170882,1780.05,1941.9,39.66635774,-60.33364226,-13.44167702,-9.496524931,0.013769789,59139782,HDFC
1341,04-06-2018,1833.15,1870.45,1825.35,1860.9,2010526,-11.1,11.1,0,48.99815012,1780.05,1929,35.64954683,-64.35045317,-12.42688554,-10.08259705,0.012790055,57129256,HDFC
1342,05-06-2018,1848.4,1854.9,1820.65,1832.1,1539190,15.25,0,15.25,54.69728251,1780.05,1919,49.19035624,-50.80964376,-10.27367983,-10.12081361,0.036301965,58668446,HDFC
1343,06-06-2018,1858.45,1861.5,1838.15,1848,1222829,10.05,0,10.05,58.24519878,1780.05,1882.1,76.82508574,-23.17491426,-7.667906935,-9.630232273,0.028985106,59891275,HDFC
1344,07-06-2018,1869,1874,1858.55,1862.5,1453806,10.55,0,10.55,61.8628877,1780.05,1874,94.67802022,-5.321979776,-4.697367975,-8.643659414,0.027064157,61345081,HDFC
1345,08-06-2018,1840.45,1863.3,1827,1855.05,1947101,-28.55,28.55,0,48.69035467,1780.05,1874,64.2895157,-35.7104843,-4.593984254,-7.833724382,0.005957749,59397980,HDFC
1346,11-06-2018,1839.45,1850,1831.35,1839.1,1561062,-1,1,0,48.27492026,1780.05,1874,63.22511974,-36.77488026,-4.540404596,-7.175060425,0.016411107,57836918,HDFC
1347,12-06-2018,1847.7,1854.8,1838.05,1840.3,1662303,8.25,0,8.25,52.16043537,1780.4,1874,71.9017094,-28.0982906,-3.78856407,-6.497761154,0.031773509,59499221,HDFC
1348,13-06-2018,1832.3,1856.25,1826.6,1851,1792766,-15.4,15.4,0,44.89646218,1780.4,1874,55.44871795,-44.55128205,-4.384830735,-6.07517507,-0.000381888,57706455,HDFC
1349,14-06-2018,1833.75,1838.5,1827,1837.5,2035114,1.45,0,1.45,45.71773262,1780.4,1874,56.99786325,-43.00213675,-4.68635213,-5.797410482,-0.005693371,59741569,HDFC
1350,15-06-2018,1832.25,1865.45,1827.1,1842,3700695,-1.5,1.5,0,44.91862671,1780.4,1874,55.39529915,-44.60470085,-4.988839239,-5.635696233,-0.000490958,56040874,HDFC
1351,18-06-2018,1823.55,1834.6,1820.2,1831.5,1965262,-8.7,8.7,0,40.21450753,1780.4,1874,46.10042735,-53.89957265,-5.862994789,-5.681155944,-0.01344406,54075612,HDFC
1352,19-06-2018,1828,1837.9,1817,1823.25,2627053,4.45,0,4.45,43.69459831,1797.2,1874,40.10416667,-59.89583333,-6.126073982,-5.770139552,-0.016384622,56702665,HDFC
1353,20-06-2018,1847,1852.1,1830.2,1832.1,1680840,19,0,19,56.24289635,1817,1874,52.63157895,-47.36842105,-4.746707835,-5.565453209,-0.011771001,58383505,HDFC
1354,21-06-2018,1858.9,1876.6,1844.45,1855,3185688,11.9,0,11.9,62.31265683,1817,1876.6,70.30201342,-29.69798658,-2.662626577,-4.984887882,0.010024722,61569193,HDFC
1355,22-06-2018,1906.75,1912.7,1853.8,1859,4070361,47.85,0,47.85,77.07003621,1817,1912.7,93.78265413,-6.217345873,2.81763796,-3.424382714,0.036587023,65639554,HDFC
1356,25-06-2018,1893.8,1911.5,1885,1909,3174077,-12.95,12.95,0,68.67283724,1817,1912.7,80.2507837,-19.7492163,6.046134245,-1.530279322,0.024949938,62465477,HDFC
1357,26-06-2018,1915.85,1922.85,1889.4,1892,2819929,22.05,0,22.05,74.1963646,1817,1922.85,93.38686821,-6.61313179,10.26565544,0.828907631,0.045598428,65285406,HDFC
1358,27-06-2018,1904.85,1936,1895.65,1922,3309395,-11,11,0,67.35993846,1817,1936,73.82352941,-26.17647059,12.57706772,3.178539649,0.038773006,61976011,HDFC
1359,28-06-2018,1878,1913,1865.5,1904,4899708,-26.85,26.85,0,53.48127199,1817,1936,51.2605042,-48.7394958,12.10279451,4.963390621,0.0249693,57076303,HDFC
1360,29-06-2018,1908.1,1913,1873,1889,4022628,30.1,0,30.1,63.27019286,1817,1936,76.55462185,-23.44537815,13.99442896,6.769598289,0.046365606,61098931,HDFC
1361,02-07-2018,1897.1,1915.35,1879.3,1912.9,2283964,-11,11,0,58.11364341,1817,1936,67.31092437,-32.68907563,14.43950519,8.303579668,0.037800875,58814967,HDFC
1362,03-07-2018,1879.7,1900,1874.65,1900,1687705,-17.4,17.4,0,50.58847707,1817,1936,52.68907563,-47.31092437,13.23562468,9.289988671,0.017704385,57127262,HDFC
1363,04-07-2018,1922.5,1926.7,1882.1,1883,2609336,42.8,0,42.8,63.86777542,1817,1936,88.65546218,-11.34453782,15.55582514,10.54315596,0.034213782,59736598,HDFC
1364,05-07-2018,1931.05,1937.15,1908.25,1923.7,1945712,8.55,0,8.55,65.9754773,1817,1937.15,94.9230129,-5.076987099,17.87842294,12.01020936,0.012744198,61682310,HDFC
1365,06-07-2018,1916.85,1938.4,1912.25,1926.1,2550768,-14.2,14.2,0,59.34192374,1817,1938.4,82.24876442,-17.75123558,18.36161582,13.28049065,0.012171296,59131542,HDFC
1366,09-07-2018,1904.9,1922,1901,1919,2377612,-11.95,11.95,0,54.06359885,1830.2,1938.4,69.03881701,-30.96118299,17.57766021,14.13992456,-0.005715479,56753930,HDFC
1367,10-07-2018,1942.55,1947.6,1904.55,1912,1847583,37.65,0,37.65,65.28792065,1844.45,1947.6,95.10421716,-4.895782841,19.76655356,15.26525036,0.019791585,58601513,HDFC
1368,11-07-2018,1928.1,1961.8,1920.3,1946,2224803,-14.45,14.45,0,58.91312888,1853.8,1961.8,68.7962963,-31.2037037,20.10353207,16.2329067,0.026677316,56376710,HDFC
1369,12-07-2018,1962.7,1979.9,1935,1938,2796172,34.6,0,34.6,67.64220442,1865.5,1979.9,84.96503497,-15.03496503,22.89856045,17.56603745,0.028614852,59172882,HDFC
1370,13-07-2018,1972.5,1978.35,1943.45,1968,2465425,9.8,0,9.8,69.74302323,1865.5,1979.9,93.53146853,-6.468531469,25.60921162,19.17467229,0.039744874,61638307,HDFC
1371,16-07-2018,1991.2,1997.5,1973,1979.95,3693133,18.7,0,18.7,73.52721198,1865.5,1997.5,95.22727273,-4.772727273,28.9328362,21.12630507,0.059317976,65331440,HDFC
1372,17-07-2018,1989.3,1998,1968,1991,2171225,-1.9,1.9,0,72.46470043,1865.5,1998,93.43396226,-6.566037736,31.05552969,23.11214999,0.034746424,63160215,HDFC
1373,18-07-2018,2009.45,2025,1998.8,2005,2796940,20.15,0,20.15,76.60213508,1873,2025,89.76973684,-10.23026316,33.97210687,25.28414137,0.040599674,65957155,HDFC
1374,19-07-2018,1988.4,2005.05,1977,2003,1385205,-21.05,21.05,0,64.8555084,1874.65,2025,75.6568008,-24.3431992,34.19082567,27.06547823,0.037326864,64571950,HDFC
1375,20-07-2018,1973.85,1982,1957.1,1980.5,1467884,-14.55,14.55,0,57.78796488,1874.65,2025,65.97938144,-34.02061856,32.81186375,28.21475533,0.036196126,63104066,HDFC
1376,23-07-2018,1966.85,1988,1959.55,1969,1254416,-7,7,0,54.49160816,1882.1,2025,59.30720784,-40.69279216,30.79915155,28.73163458,0.012509331,61849650,HDFC
1377,24-07-2018,1975.55,1982.8,1962.15,1967.1,1628220,8.7,0,8.7,57.93280472,1901,2025,60.12096774,-39.87903226,29.56526989,28.89836164,0.024609719,63477870,HDFC
1378,25-07-2018,2000.85,2011.85,1984.2,1988.45,2503749,25.3,0,25.3,66.44629504,1901,2025,80.52419355,-19.47580645,30.27986096,29.1746615,0.01943751,65981619,HDFC
1379,26-07-2018,2023.4,2034.1,1991,2004.3,3909895,22.55,0,22.55,72.22677978,1901,2034.1,91.96093163,-8.03906837,32.29351651,29.7984325,0.025804816,69891514,HDFC
1380,27-07-2018,2047.25,2049.95,2023.25,2032,1956967,23.85,0,23.85,77.05146045,1904.55,2049.95,98.14305365,-1.856946355,35.40571369,30.91988874,0.028148855,71848481,HDFC
1381,30-07-2018,2028.75,2052.95,2013.8,2047,2176046,-18.5,18.5,0,66.68352805,1920.3,2052.95,81.75650207,-18.24349793,35.96477743,31.92886648,0.019831096,69672435,HDFC
1382,31-07-2018,1994.85,2018.6,1971,2018.6,3581217,-33.9,33.9,0,51.91386674,1935,2052.95,50.74183976,-49.25816024,33.28866181,32.20082554,-0.00726567,66091218,HDFC
1383,01-08-2018,1970.15,1995.2,1959.65,1995,3415429,-24.7,24.7,0,43.76457533,1943.45,2052.95,24.38356164,-75.61643836,28.84226169,31.52911277,-0.009178234,62675789,HDFC
1384,02-08-2018,1931.95,1966.5,1927.35,1962,2595747,-38.2,38.2,0,34.18775449,1927.35,2052.95,3.662420382,-96.33757962,21.98263468,29.61981715,-0.02122755,60080042,HDFC
1385,03-08-2018,1977.5,1980,1941,1945,2346246,45.55,0,45.55,49.41693975,1927.35,2052.95,39.92834395,-60.07165605,19.99138691,27.6941311,0.005414749,62426288,HDFC
1386,06-08-2018,1979.3,1999,1965.05,1999,2219237,1.8,0,1.8,49.94507939,1927.35,2052.95,41.36146497,-58.63853503,18.34706017,25.82471692,0.001898206,64645525,HDFC
1387,07-08-2018,1978.6,1992.9,1968.55,1982,1680478,-0.7,0.7,0,49.71217383,1927.35,2052.95,40.80414013,-59.19585987,16.79384624,24.01854278,-0.011120274,62965047,HDFC
1388,08-08-2018,1984.6,1989.75,1953.4,1976,1507070,6,0,6,51.92919416,1927.35,2052.95,45.58121019,-54.41878981,15.86419034,22.38767229,-0.019175645,64472117,HDFC
1389,09-08-2018,1969.95,1988.7,1961.35,1988,1789926,-14.65,14.65,0,46.19190231,1927.35,2052.95,33.91719745,-66.08280255,13.786378,20.66741344,-0.037757968,62682191,HDFC
1390,10-08-2018,1974.3,1980,1951.3,1969.95,1737395,4.35,0,4.35,48.15438976,1927.35,2052.95,37.38057325,-62.61942675,12.34836118,19.00360298,-0.026839187,64419586,HDFC
1391,13-08-2018,1947,1967.35,1939.2,1967,1195249,-27.3,27.3,0,38.09359101,1927.35,2052.95,15.64490446,-84.35509554,8.903209976,16.98352438,-0.023986766,63224337,HDFC
1392,14-08-2018,1941.5,1970.65,1937.8,1956,1761582,-5.5,5.5,0,36.32917859,1927.35,2052.95,11.26592357,-88.73407643,5.663809918,14.71958149,-0.01454204,61462755,HDFC
1393,16-08-2018,1891.2,1936.5,1888.55,1936.5,3850598,-50.3,50.3,0,24.40220118,1888.55,2052.95,1.611922141,-98.38807786,-0.951262036,11.58541278,-0.021092678,57612157,HDFC
1394,17-08-2018,1885.65,1903,1881,1897,2387431,-5.55,5.55,0,23.42317677,1881,2052.95,2.704274498,-97.2957255,-6.565905167,7.955149194,-0.046447535,55224726,HDFC
1395,20-08-2018,1920.05,1923.55,1891.3,1894.75,1815999,34.4,0,34.4,40.49657122,1881,2018.6,28.37936047,-71.62063953,-8.145857419,4.734947872,-0.029934825,57040725,HDFC
1396,21-08-2018,1913.35,1931.8,1906.55,1915.05,1602054,-6.7,6.7,0,38.56428236,1881,1999,27.41525424,-72.58474576,-9.825354397,1.822887418,-0.032977863,55438671,HDFC
1397,23-08-2018,1906.3,1954.95,1900.5,1954.95,2900920,-7.05,7.05,0,36.45252677,1881,1999,21.44067797,-78.55932203,-11.59162292,-0.86001465,-0.039453794,52537751,HDFC
1398,24-08-2018,1919.05,1921.65,1901,1904,1594287,12.75,0,12.75,42.9693467,1881,1999,32.24576271,-67.75423729,-11.82625925,-3.05326357,-0.025838219,54132038,HDFC
1399,27-08-2018,1924.85,1935,1916.7,1926.9,1366731,5.8,0,5.8,45.88235701,1881,1999,37.16101695,-62.83898305,-11.41264089,-4.725139033,-0.025046852,55498769,HDFC
1400,28-08-2018,1955.15,1958.95,1926,1927.2,2013110,30.3,0,30.3,58.62218965,1881,1992.9,66.26452189,-33.73547811,-8.541428312,-5.488396889,0.004185927,57511879,HDFC
1401,29-08-2018,1956.25,1971.4,1944.7,1959.4,2367281,1.1,0,1.1,59.02623369,1881,1989.75,69.1954023,-30.8045977,-6.106815288,-5.612080569,0.007597219,59879160,HDFC
1402,30-08-2018,1934.15,1964.45,1928.25,1950,2466442,-22.1,22.1,0,48.13106086,1881,1988.7,49.35004643,-50.64995357,-5.892724568,-5.668209369,0.022710448,57412718,HDFC
1403,31-08-2018,1935.95,1942.45,1908.05,1940.9,3856093,1.8,0,1.8,49.01547478,1881,1980,55.50505051,-44.49494949,-5.514246373,-5.63741677,0.026675152,61268811,HDFC
1404,03-09-2018,1944.8,1950,1928.1,1950,2310201,8.85,0,8.85,53.51228987,1881,1971.4,70.57522124,-29.42477876,-4.448894553,-5.399712326,0.012890289,63579012,HDFC
1405,04-09-2018,1954.8,1959.65,1939,1939,2928533,10,0,10,58.30672351,1881,1971.4,81.63716814,-18.36283186,-2.76579675,-4.872929211,0.021663574,66507545,HDFC
1406,05-09-2018,1937.4,1965,1923.05,1950,3587932,-17.4,17.4,0,48.30474139,1881,1971.4,62.38938053,-37.61061947,-2.803645517,-4.459072472,0.016314326,62919613,HDFC
1407,06-09-2018,1956.15,1960.6,1928.45,1949,4311847,18.75,0,18.75,57.392442,1881,1971.4,83.13053097,-16.86946903,-1.305622237,-3.828382425,0.019332482,67231460,HDFC
1408,07-09-2018,1920,1963.5,1915.05,1963.5,2253314,-36.15,36.15,0,41.25766733,1891.3,1971.4,35.83021223,-64.16978777,-3.000839072,-3.662873755,-0.002519677,64978146,HDFC
1409,10-09-2018,1883.55,1916,1878.25,1915,2191420,-36.45,36.45,0,31.0892108,1878.25,1971.4,5.689747719,-94.31025228,-7.202495122,-4.370798028,-0.036621231,62786726,HDFC
1410,11-09-2018,1868.05,1892.55,1860.45,1890,4062178,-15.5,15.5,0,27.73520493,1860.45,1971.4,6.849932402,-93.1500676,-11.64877841,-5.826394104,-0.045086262,58724548,HDFC
1411,12-09-2018,1877.8,1886.75,1856.55,1878.9,2641076,9.75,0,9.75,32.98281018,1856.55,1971.4,18.50239443,-81.49760557,-14.2218063,-7.505476543,-0.029134245,61365624,HDFC
1412,14-09-2018,1925.45,1928.95,1882.1,1892,3521562,47.65,0,47.65,52.45279366,1856.55,1971.4,59.99129299,-40.00870701,-12.27449987,-8.459281209,-0.005423694,64887186,HDFC
1413,17-09-2018,1878.85,1910,1871,1910,2164001,-46.6,46.6,0,39.50260659,1856.55,1971.4,19.41663039,-80.58336961,-14.32633102,-9.632691172,-0.033910942,62723185,HDFC
1414,18-09-2018,1855.7,1888.75,1847.05,1877.25,2905388,-23.15,23.15,0,34.6052434,1847.05,1971.4,6.956172095,-93.04382791,-17.61735166,-11.22962327,-0.050695723,59817797,HDFC
1415,19-09-2018,1830.65,1864,1824.15,1860.4,4046901,-25.05,25.05,0,29.96671392,1824.15,1965,4.614838481,-95.38516152,-21.99330968,-13.38236055,-0.055099618,55770896,HDFC
1416,21-09-2018,1839.4,1875,1783,1835.65,6425727,8.75,0,8.75,33.55626925,1783,1965,30.98901099,-69.01098901,-24.47312512,-15.60051347,-0.059683562,62196623,HDFC
1417,24-09-2018,1718.7,1846.25,1702.8,1839,9026730,-120.7,120.7,0,18.4801653,1702.8,1965,6.064073227,-93.93592677,-35.76559448,-19.63352967,-0.10484375,53169893,HDFC
1418,25-09-2018,1773.35,1784,1713.8,1728.8,7202463,54.65,0,54.65,33.97695692,1702.8,1965,26.90694127,-73.09305873,-39.84584148,-23.67599203,-0.058506543,60372356,HDFC
1419,26-09-2018,1767.45,1806.3,1756.1,1783.6,4044415,-5.9,5.9,0,33.19098259,1702.8,1965,24.65675057,-75.34324943,-43.0591878,-27.55263118,-0.053852948,56327941,HDFC
1420,27-09-2018,1729,1768.75,1726.15,1767.15,5971180,-38.45,38.45,0,28.27299006,1702.8,1963.5,10.04986575,-89.95013425,-48.15330029,-31.67276501,-0.079241666,50356761,HDFC
1421,28-09-2018,1754.5,1773.5,1736,1742,6882950,25.5,0,25.5,35.57759046,1702.8,1963.5,19.83122363,-80.16877637,-49.56147048,-35.2505061,-0.08878444,57239711,HDFC
1422,01-10-2018,1806.35,1817.1,1753.1,1765.7,2700216,51.85,0,51.85,48.00156368,1702.8,1928.95,45.78819368,-54.21180632,-45.9637523,-37.39315534,-0.038587434,59939927,HDFC
1423,03-10-2018,1797.55,1819.45,1785.65,1804.8,3808517,-8.8,8.8,0,46.25469142,1702.8,1928.95,41.89697104,-58.10302896,-43.32321809,-38.57916789,-0.031335884,56131410,HDFC
1424,04-10-2018,1778.45,1797.95,1742.35,1780,4280606,-19.1,19.1,0,42.39119899,1702.8,1928.95,33.45124917,-66.54875083,-42.28435832,-39.32020598,-0.028514462,51850804,HDFC
1425,05-10-2018,1708.65,1775,1683.75,1768.7,4109132,-69.8,69.8,0,31.34970767,1683.75,1928.95,10.15497553,-89.84502447,-46.55665498,-40.76749578,-0.071082962,47741672,HDFC
1426,08-10-2018,1667.7,1708.55,1646.55,1695.8,4939555,-40.95,40.95,0,26.6506918,1646.55,1910,8.028088821,-91.97191118,-52.64000245,-43.14199711,-0.029673591,42802117,HDFC
1427,09-10-2018,1712.75,1734,1671.6,1682.7,3082730,45.05,0,45.05,38.37572396,1646.55,1888.75,27.33278282,-72.66721718,-53.21253962,-45.15610561,-0.034172611,45884847,HDFC
1428,10-10-2018,1736.95,1768,1716.65,1717.4,2358736,24.2,0,24.2,43.93104266,1646.55,1875,39.57102211,-60.42897789,-51.12421358,-46.34972721,-0.017256499,48243583,HDFC
1429,11-10-2018,1684.55,1724.1,1675.7,1690,3267234,-52.4,52.4,0,35.85542346,1646.55,1875,16.63383673,-83.36616327,-53.08550557,-47.69688288,-0.025708502,44976349,HDFC
1430,12-10-2018,1730.3,1741.5,1694.5,1705.9,2731113,45.75,0,45.75,45.87812646,1646.55,1846.25,41.93790686,-58.06209314,-50.36759467,-48.23102524,-0.013793103,47707462,HDFC
1431,15-10-2018,1732.9,1765.5,1703.65,1755,2996773,2.6,0,2.6,46.42703596,1646.55,1819.45,49.9421631,-50.0578369,-47.4567802,-48.07617623,-0.040662109,50704235,HDFC
1432,16-10-2018,1756.25,1773.7,1713.15,1735,3427228,23.35,0,23.35,51.52192509,1646.55,1819.45,63.44707924,-36.55292076,-42.77273149,-47.01548728,-0.022975717,54131463,HDFC
1433,17-10-2018,1737.8,1775,1729.5,1772,3584746,-18.45,18.45,0,47.41112188,1646.55,1819.45,52.7761712,-47.2238288,-40.08724909,-45.62983964,-0.022856982,50546717,HDFC
1434,19-10-2018,1660.25,1760.95,1651.7,1725,5363667,-77.55,77.55,0,34.18344074,1646.55,1819.45,7.923655292,-92.07634471,-43.7127287,-45.24641745,-0.028326457,45183050,HDFC
1435,22-10-2018,1658.3,1689.7,1649.45,1683.9,4632839,-1.95,1.95,0,33.90895574,1646.55,1819.45,6.795835743,-93.20416426,-46.21060898,-45.43925576,-0.005636505,40550211,HDFC
1436,23-10-2018,1686.75,1710,1644.5,1645,3734275,28.45,0,28.45,41.77901427,1644.5,1819.45,24.14975707,-75.85024293,-45.3715054,-45.42570569,-0.015180266,44284486,HDFC
1437,24-10-2018,1741.45,1748.5,1706.6,1715,3598576,54.7,0,54.7,53.94539433,1644.5,1797.95,63.18018899,-36.81981101,-39.8335011,-44.30726477,0.002590748,47883062,HDFC
1438,25-10-2018,1694.45,1740,1685.05,1729.75,4435395,-47,47,0,44.68725096,1644.5,1775,38.27586207,-61.72413793,-38.78995356,-43.20380253,0.00587694,43447667,HDFC
1439,26-10-2018,1702.1,1719.85,1675.5,1694,2780124,7.65,0,7.65,46.41439729,1644.5,1775,44.13793103,-55.86206897,-36.92005217,-41.94705246,-0.016297752,46227791,HDFC
1440,29-10-2018,1698.4,1710,1653.05,1705,5326330,-3.7,3.7,0,45.61944317,1644.5,1775,41.30268199,-58.69731801,-35.32944508,-40.62353098,-0.019908823,40901461,HDFC
1441,30-10-2018,1671.9,1710,1663.2,1703,2073955,-26.5,26.5,0,39.96304492,1644.5,1775,20.99616858,-79.00383142,-35.79458829,-39.65774244,-0.04802847,38827506,HDFC
1442,31-10-2018,1769.25,1774.5,1677.1,1678,6450539,97.35,0,97.35,60.64613361,1644.5,1775,95.59386973,-4.406130268,-27.98528924,-37.3232518,0.018097595,45278045,HDFC
1443,01-11-2018,1762,1794.9,1748.25,1776.8,5142502,-7.25,7.25,0,58.90240177,1644.5,1794.9,78.125,-21.875,-22.12631944,-34.28386533,0.061285951,40135543,HDFC
1444,02-11-2018,1824.4,1836.9,1765.5,1790,3701701,62.4,0,62.4,68.03093505,1644.5,1836.9,93.5031185,-6.496881497,-12.30602893,-29.88829805,0.100162817,43837244,HDFC
1445,05-11-2018,1792.9,1824.4,1773.35,1811.25,3291569,-31.5,31.5,0,60.23755639,1644.5,1836.9,77.13097713,-22.86902287,-6.984649989,-25.30756844,0.062931673,40545675,HDFC
1446,06-11-2018,1805.9,1814,1783.1,1801.4,2033692,13,0,13,62.29442078,1644.5,1836.9,83.88773389,-16.11226611,-1.698844268,-20.5858236,0.037009389,42579367,HDFC
1447,07-11-2018,1815.85,1819,1807.65,1813.55,124505,9.95,0,9.95,63.94169368,1644.5,1836.9,89.05925156,-10.94074844,3.255548753,-15.81754913,0.071645667,42703872,HDFC
1448,09-11-2018,1816.1,1832.7,1780,1820,4002556,0.25,0,0.25,63.98730581,1644.5,1836.9,89.18918919,-10.81081081,7.120038456,-11.23003162,0.066976088,46706428,HDFC
1449,12-11-2018,1795.9,1838.45,1789.35,1817.1,2020191,-20.2,20.2,0,57.23717043,1644.5,1838.45,78.06135602,-21.93864398,8.455236503,-7.292977991,0.057406971,44686237,HDFC
1450,13-11-2018,1824.7,1829,1784.55,1790,1812035,28.8,0,28.8,63.56092526,1653.05,1838.45,92.58360302,-7.41639698,11.70241177,-3.49390004,0.091393026,46498272,HDFC
1451,14-11-2018,1839.15,1850,1830.25,1836,2899132,14.45,0,14.45,66.43451512,1653.05,1850,94.49098756,-5.50901244,15.26584068,0.258048104,0.039508266,49397404,HDFC
1452,15-11-2018,1853.6,1858,1824.2,1837,1666149,14.45,0,14.45,69.2339897,1653.05,1858,97.85313491,-2.146865089,19.0364378,4.013726044,0.051986379,51063553,HDFC
1453,16-11-2018,1889,1892.9,1850,1861,2925841,35.4,0,35.4,75.10353667,1653.05,1892.9,98.37398374,-1.62601626,24.5976015,8.130501135,0.035408902,53989394,HDFC
1454,19-11-2018,1899.35,1906.95,1872.8,1899.95,2675368,10.35,0,10.35,76.60899024,1663.2,1906.95,96.88205128,-3.117948718,29.49996506,12.40439392,0.059373083,56664762,HDFC
1455,20-11-2018,1876.8,1904,1872.05,1890,2123458,-22.55,22.55,0,66.50004689,1677.1,1906.95,86.88274962,-13.11725038,31.20580586,16.16467631,0.039260203,54541304,HDFC
1456,21-11-2018,1868.15,1891.25,1864,1877.1,2394930,-8.65,8.65,0,62.83048748,1748.25,1906.95,75.55135476,-24.44864524,31.4966406,19.23106917,0.028801938,52146374,HDFC
1457,22-11-2018,1873.7,1889.2,1866.65,1872,1646774,5.55,0,5.55,64.28935046,1765.5,1906.95,76.49346059,-23.50653941,31.80830155,21.74651564,0.031716315,53793148,HDFC
1458,26-11-2018,1884.65,1891.3,1869,1883.9,2375787,10.95,0,10.95,67.21840068,1773.35,1906.95,83.30838323,-16.69161677,32.56349686,23.90991189,0.049418119,56168935,HDFC
1459,27-11-2018,1901.7,1908.8,1870,1884.65,2486736,17.05,0,17.05,71.42873607,1780,1908.8,94.48757764,-5.51242236,34.14419408,25.95676832,0.042198718,58655671,HDFC
1460,28-11-2018,1928,1930.9,1907.15,1909,3140874,26.3,0,26.3,76.74475726,1780,1930.9,98.07819748,-1.921802518,37.09153014,28.18372069,0.048310361,61796545,HDFC
1461,29-11-2018,1956.3,1965,1935,1940,3832797,28.3,0,28.3,81.1088522,1780,1965,95.2972973,-4.702702703,41.23555093,30.79408674,0.055405697,65629342,HDFC
1462,30-11-2018,1989,1998.75,1962.8,1970,4236401,32.7,0,32.7,84.88946624,1784.55,1998.75,95.44817927,-4.551820728,46.62091706,33.9594528,0.052938062,69865743,HDFC
1463,03-12-2018,1980.75,2017,1955,2000.15,3249616,-8.25,8.25,0,80.21620345,1784.55,2017,84.40524844,-15.59475156,49.65080886,37.09772401,0.042856767,66616127,HDFC
1464,04-12-2018,1939.45,1980,1917.7,1980,3914521,-41.3,41.3,0,60.86263136,1824.2,2017,59.77697095,-40.22302905,48.16424762,39.31102873,0.033381287,62701606,HDFC
1465,05-12-2018,1973.3,1979.8,1920.6,1927,3147110,33.85,0,33.85,68.13354944,1824.2,2017,77.3340249,-22.6659751,49.15096748,41.27901648,0.05628563,65848716,HDFC
1466,06-12-2018,1945.8,1969.8,1938,1955.05,4278616,-27.5,27.5,0,58.02805495,1850,2017,57.36526946,-42.63473054,47.17018142,42.45724947,0.038480013,61570100,HDFC
1467,07-12-2018,1951.35,1961.3,1929.1,1946.9,2442617,5.55,0,5.55,59.42930986,1864,2017,57.09150327,-42.90849673,45.52346662,43.0704929,0.035391187,64012717,HDFC
1468,10-12-2018,1906.5,1939.9,1901.25,1924.35,2182278,-44.85,44.85,0,45.32100205,1864,2017,27.77777778,-72.22222222,40.13674173,42.48374267,0.002524057,61830439,HDFC
1469,11-12-2018,1905.25,1912.65,1855.25,1878,3547051,-1.25,1.25,0,44.97762895,1855.25,2017,30.91190108,-69.08809892,35.35925937,41.05884601,-0.011799793,58283388,HDFC
1470,12-12-2018,1940.2,1946.8,1904.25,1912,2228690,34.95,0,34.95,55.78502812,1855.25,2017,52.51931994,-47.48068006,34.00129729,39.64733626,-0.008229822,60512078,HDFC
1471,13-12-2018,1942.05,1961.9,1927.9,1945,2778618,1.85,0,1.85,56.30916497,1855.25,2017,53.66306028,-46.33693972,32.69746606,38.25736222,-0.023604827,63290696,HDFC
1472,14-12-2018,1904.1,1955,1898.05,1945,3459751,-37.95,37.95,0,43.9714644,1855.25,2017,30.20092736,-69.79907264,28.27597475,36.26108473,-0.038697463,59830945,HDFC
1473,17-12-2018,1960.35,1963.4,1913.7,1915,2030693,56.25,0,56.25,59.24385162,1855.25,2017,64.97681607,-35.02318393,28.97678954,34.80422569,0.010776251,61861638,HDFC
1474,18-12-2018,1952,1957.9,1932.5,1955,2121103,-8.35,8.35,0,56.6012277,1855.25,2017,59.81452859,-40.18547141,28.52954426,33.5492894,-0.010794101,59740535,HDFC
1475,19-12-2018,1981.7,1985.5,1948.55,1954,2560551,29.7,0,29.7,63.31672343,1855.25,2017,78.17619784,-21.82380216,30.22324617,32.88408076,0.018449995,62301086,HDFC
1476,20-12-2018,1974.7,1982,1943.05,1970,1829220,-7,7,0,60.7598636,1855.25,2017,73.84853168,-26.15146832,30.64739159,32.43674293,0.011966075,60471866,HDFC
1477,21-12-2018,1948.6,1979.6,1930,1974.8,4016548,-26.1,26.1,0,51.76640273,1855.25,1985.5,71.66986564,-28.33013436,28.54838995,31.65907233,0.02208235,56455318,HDFC
1478,24-12-2018,1902.15,1955,1898,1955,2207727,-46.45,46.45,0,39.69966191,1855.25,1985.5,36.00767754,-63.99232246,22.87312211,29.90188229,-0.001627083,54247591,HDFC
1479,26-12-2018,1933.35,1944.7,1883.2,1896,1536116,31.2,0,31.2,48.92652701,1855.25,1985.5,59.96161228,-40.03838772,20.65491372,28.05248857,-0.003530564,55783707,HDFC
1480,27-12-2018,1948.85,1955,1930,1948.45,1645443,15.5,0,15.5,53.0450441,1855.25,1985.5,71.86180422,-28.13819578,19.91808477,26.42560781,0.003501455,57429150,HDFC
1481,28-12-2018,1979.95,1990,1952,1959,2384400,31.1,0,31.1,60.43200963,1855.25,1990,92.54174397,-7.45825603,21.59472209,25.45943067,0.039835093,59813550,HDFC
1482,31-12-2018,1968.35,1989.75,1961.55,1988,2289993,-11.6,11.6,0,56.59983486,1855.25,1990,83.93320965,-16.06679035,21.73687701,24.71491994,0.004080904,57523557,HDFC
1483,01-01-2019,2009,2014.7,1954.5,1968,1305443,40.65,0,40.65,65.45690338,1883.2,2014.7,95.66539924,-4.33460076,24.84327329,24.74059061,0.02920082,58829000,HDFC
1484,02-01-2019,1980.65,2009,1961,2004.7,2001170,-28.35,28.35,0,56.22358928,1883.2,2014.7,74.10646388,-25.89353612,24.73240686,24.73895386,-0.000529848,56827830,HDFC
1485,03-01-2019,1936.85,1987.1,1931.85,1984.05,3732193,-43.8,43.8,0,44.92635173,1883.2,2014.7,40.79847909,-59.20152091,20.86967781,23.96509865,-0.019167468,53095637,HDFC
1486,04-01-2019,1972.6,1976,1942,1948,2109614,35.75,0,35.75,53.68988764,1883.2,2014.7,67.98479087,-32.01520913,20.45734391,23.2635477,0.012316535,55205251,HDFC
1487,07-01-2019,1972.9,1987.5,1963.95,1976.95,2255477,0.3,0,0.3,53.7611296,1883.2,2014.7,68.21292776,-31.78707224,19.92508978,22.59585612,0.037194753,57460728,HDFC
1488,08-01-2019,1958.95,1983,1948,1983,2061919,-13.95,13.95,0,49.66205723,1883.2,2014.7,57.60456274,-42.39543726,18.1681945,21.71032379,0.013241265,55398809,HDFC
1489,09-01-2019,1994.95,1998,1962,1962,2905090,36,0,36,58.97596223,1883.2,2014.7,84.98098859,-15.01901141,19.45645951,21.25955094,0.023654976,58303899,HDFC
1490,10-01-2019,1980.1,1993,1971.3,1993,2138302,-14.85,14.85,0,54.20256032,1883.2,2014.7,73.68821293,-26.31178707,19.05944253,20.81952926,7.58E-05,56165597,HDFC
1491,11-01-2019,1991.4,2007.7,1972.4,1978,1814132,11.3,0,11.3,57.24119457,1883.2,2014.7,82.28136882,-17.71863118,19.43261222,20.54214585,0.011710316,57979729,HDFC
1492,14-01-2019,1969.2,1983.15,1949.6,1983,2167796,-22.2,22.2,0,49.7574676,1883.2,2014.7,65.39923954,-34.60076046,17.73258719,19.98023412,-0.019810851,55811933,HDFC
1493,15-01-2019,1992.15,1996,1964,1975.2,2111042,22.95,0,22.95,56.53574189,1930,2014.7,73.37662338,-26.62337662,18.02934722,19.59005674,0.005806175,57922975,HDFC
1494,16-01-2019,1975,1994.75,1965.5,1989,1878811,-17.15,17.15,0,50.64447093,1931.85,2014.7,52.08207604,-47.91792396,16.6882977,19.00970493,0.019696931,56044164,HDFC
1495,17-01-2019,2004.55,2007,1979.05,1982.75,2773741,29.55,0,29.55,59.11468713,1931.85,2014.7,87.74894387,-12.25105613,17.8047028,18.7687045,0.016196897,58817905,HDFC
1496,18-01-2019,2006.85,2012.6,1989.25,2004,1942136,2.3,0,2.3,59.73527274,1931.85,2014.7,90.52504526,-9.474954737,18.65995235,18.74695407,0.017208171,60760041,HDFC
1497,21-01-2019,2004.45,2016,1983.2,1998,2146668,-2.4,2.4,0,58.66318258,1931.85,2016,86.2745098,-13.7254902,18.92591764,18.78274679,0.023226729,58613373,HDFC
1498,22-01-2019,1979.4,2002.15,1968.5,1999,3502920,-25.05,25.05,0,48.23700358,1931.85,2016,56.50623886,-43.49376114,16.92032443,18.41026232,-0.007794682,55110453,HDFC
1499,23-01-2019,1958.25,1984.95,1951.3,1981.8,2201110,-21.15,21.15,0,41.11768035,1942,2016,21.95945946,-78.04054054,13.46898703,17.42200726,-0.011034796,52909343,HDFC
1500,24-01-2019,1971.1,1976,1942.15,1960,2194496,12.85,0,12.85,46.63877097,1942.15,2016,39.20108328,-60.79891672,11.63652624,16.26491105,-0.010193833,55103839,HDFC
1501,25-01-2019,1977.8,1993,1963.95,1964.4,2240491,6.7,0,6.7,49.48816613,1942.15,2016,48.27352742,-51.72647258,10.60270054,15.13246895,0.004367256,57344330,HDFC
1502,28-01-2019,1946.9,1982.2,1938.1,1978.7,2698966,-30.9,30.9,0,38.53747169,1938.1,2016,11.29653402,-88.70346598,7.206937382,13.54736264,-0.022714153,54645364,HDFC
1503,29-01-2019,1922.3,1949.9,1893.3,1943.7,4035877,-24.6,24.6,0,32.02739069,1893.3,2016,23.63488183,-76.36511817,2.501915676,11.33827325,-0.026683544,50609487,HDFC
1504,30-01-2019,1885.8,1929.3,1869.5,1924.6,4127767,-36.5,36.5,0,24.84270569,1869.5,2016,11.12627986,-88.87372014,-4.124547663,8.245709064,-0.059240228,46481720,HDFC
1505,31-01-2019,1922.35,1941.2,1877.3,1883,5303839,36.55,0,36.55,40.31327647,1869.5,2016,36.07508532,-63.92491468,-6.353548311,5.325857589,-0.042105788,51785559,HDFC
1506,01-02-2019,1961.25,1974.45,1925.1,1929,4867443,38.9,0,38.9,52.35663808,1869.5,2016,62.62798635,-37.37201365,-4.924377328,3.275810606,-0.021552047,56653002,HDFC
1507,04-02-2019,1978.5,1981.95,1942,1959.9,1421635,17.25,0,17.25,56.81513954,1869.5,2016,74.40273038,-25.59726962,-2.372469836,2.146154517,-0.000454683,58074637,HDFC
1508,05-02-2019,1981.4,1985,1962.25,1979.8,1450509,2.9,0,2.9,57.58508841,1869.5,2016,76.38225256,-23.61774744,-0.11473639,1.693976336,0.01182178,59525146,HDFC
1509,06-02-2019,1987.95,1994.9,1975.5,1983.6,2036890,6.55,0,6.55,59.46837158,1869.5,2016,80.85324232,-19.14675768,2.177957751,1.790772619,0.008548526,61562036,HDFC
1510,07-02-2019,1969.65,1991.95,1962.55,1990.05,2722458,-18.3,18.3,0,52.02204355,1869.5,2016,68.36177474,-31.63822526,2.489578997,1.930533895,-0.00412074,58839578,HDFC
1511,08-02-2019,1944.65,1968.6,1936.85,1963.1,2187808,-25,25,0,43.44672951,1869.5,2002.15,56.65284583,-43.34715417,0.711053433,1.686637802,-0.001155683,56651770,HDFC
1512,11-02-2019,1948.2,1959,1935.6,1943.9,2209258,3.55,0,3.55,44.93397481,1869.5,1994.9,62.75917065,-37.24082935,-0.407290567,1.267852128,0.013473443,58861028,HDFC
1513,12-02-2019,1905.05,1956.4,1901.15,1950,2642567,-43.15,43.15,0,32.82657658,1869.5,1994.9,28.3492823,-71.6507177,-4.721009763,0.07007975,0.010207869,56218461,HDFC
1514,13-02-2019,1930.5,1943,1907.1,1907.1,3710809,25.45,0,25.45,43.23553821,1869.5,1994.9,48.64433812,-51.35566188,-6.016704178,-1.147277036,0.004239603,59929270,HDFC
1515,14-02-2019,1900.7,1929.25,1893.85,1921,2511047,-29.8,29.8,0,35.75086471,1869.5,1994.9,24.88038278,-75.11961722,-9.340490923,-2.785919813,-0.030873168,57418223,HDFC
1516,15-02-2019,1874.9,1900.6,1856.5,1900.6,2647706,-25.8,25.8,0,30.47982996,1856.5,1994.9,13.29479769,-86.70520231,-13.89627266,-5.007990383,-0.052362901,54770517,HDFC
1517,18-02-2019,1874.85,1893,1864.05,1877.3,2768637,-0.05,0.05,0,30.46978434,1856.5,1994.9,13.25867052,-86.74132948,-17.31124386,-7.468641078,-0.053775109,52001880,HDFC
1518,19-02-2019,1853.45,1888.5,1844.25,1870,2988645,-21.4,21.4,0,26.20463565,1844.25,1994.9,6.106870229,-93.89312977,-21.49663446,-10.27423975,-0.067657637,49013235,HDFC
1519,20-02-2019,1870.5,1874.95,1858,1865,2645051,17.05,0,17.05,34.61820282,1844.25,1994.9,17.42449386,-82.57550614,-23.17069679,-12.85353116,-0.050338893,51658286,HDFC
1520,21-02-2019,1891.45,1894.7,1865.1,1871,1578842,20.95,0,20.95,43.71613235,1844.25,1994.9,31.33089944,-68.66910056,-22.54700549,-14.79222603,-0.027357108,53237128,HDFC
1521,22-02-2019,1887.4,1899,1877.5,1893.95,2461406,-4.05,4.05,0,42.4000855,1844.25,1994.9,28.64254895,-71.35745105,-22.12448946,-16.25867871,-0.031208295,50775722,HDFC
1522,25-02-2019,1894.5,1897.9,1871.5,1897.9,2049742,7.1,0,7.1,45.7062947,1844.25,1994.9,33.35545967,-66.64454033,-20.97494567,-17.20193211,-0.005537912,52825464,HDFC
1523,26-02-2019,1853.65,1894.65,1850,1874,3756159,-40.85,40.85,0,33.09515093,1844.25,1991.95,6.364251862,-93.63574814,-23.09396469,-18.38033862,-0.03980834,49069305,HDFC
1524,27-02-2019,1841,1870,1820,1868,3412510,-12.65,12.65,0,30.12516577,1820,1968.6,14.13189771,-85.86810229,-25.50010251,-19.8042914,-0.031409481,45656795,HDFC
1525,28-02-2019,1841.2,1853.65,1834.6,1849,5693899,0.2,0,0.2,30.23937145,1820,1959,15.25179856,-84.74820144,-27.07869934,-21.25917299,-0.017974292,51350694,HDFC
1526,01-03-2019,1859.45,1863.4,1838.3,1850.4,2679223,18.25,0,18.25,40.48168951,1820,1956.4,28.92228739,-71.07771261,-26.55106211,-22.31755081,-0.00821399,54029917,HDFC
1527,05-03-2019,1860,1868.4,1838.55,1856.8,2256049,0.55,0,0.55,40.78401486,1820,1943,32.5203252,-67.4796748,-25.79122026,-23.0122847,0.00353395,56285966,HDFC
1528,06-03-2019,1885.2,1889.5,1858.8,1864.7,1828916,25.2,0,25.2,53.31959273,1820,1929.25,59.67963387,-40.32036613,-22.89172913,-22.98817359,0.007858861,58114882,HDFC
1529,07-03-2019,1880.2,1892,1865.2,1892,2171462,-5,5,0,50.85493902,1820,1900.6,74.6898263,-25.3101737,-20.75803404,-22.54214568,-0.005947818,55943420,HDFC
1530,08-03-2019,1884.05,1888,1871.1,1879,1845737,3.85,0,3.85,52.79362886,1820,1899,81.07594937,-18.92405063,-18.5426543,-21.7422474,-0.001774928,57789157,HDFC
1531,11-03-2019,1897.55,1903.8,1884,1886.35,3170249,13.5,0,13.5,59.29102787,1820,1903.8,92.54176611,-7.45823389,-15.51872255,-20.49754243,0.001609923,60959406,HDFC
1532,12-03-2019,1930,1936.65,1900.1,1914.9,3692761,32.45,0,32.45,70.53789443,1820,1936.65,94.2991856,-5.700814402,-10.38408972,-18.47485189,0.041189005,64652167,HDFC
1533,13-03-2019,1950.65,1964.4,1923.4,1939,3570861,20.65,0,20.65,75.50660456,1820,1964.4,90.47783934,-9.522160665,-4.595598596,-15.69900123,0.059560022,68223028,HDFC
1534,14-03-2019,1956.95,1975.1,1949.3,1971.8,3985679,6.3,0,6.3,76.87922561,1820,1975.1,88.29787234,-11.70212766,0.494479622,-12.46030506,0.062866609,72208707,HDFC
1535,15-03-2019,1974.65,1991.7,1955.9,1960,5984639,17.7,0,17.7,80.43380808,1820,1991.7,90.06988934,-9.930110658,5.888763358,-8.790491377,0.061953804,78193346,HDFC
1536,18-03-2019,1962.4,1994.95,1953.1,1982,2563905,-12.25,12.25,0,71.63863753,1820,1994.95,81.3946842,-18.6053158,9.070737643,-5.218245573,0.055053763,75629441,HDFC
1537,19-03-2019,1967.85,1978.55,1962.1,1972.9,2827631,5.45,0,5.45,73.14601723,1820,1994.95,84.50985996,-15.49014004,11.89512504,-1.795571449,0.043841502,78457072,HDFC
1538,20-03-2019,1987.55,1998,1968.1,1975,3654200,19.7,0,19.7,78.01868564,1834.6,1998,93.60465116,-6.395348837,15.54391717,1.672326274,0.05709499,82111272,HDFC
1539,22-03-2019,1981.55,2010,1970.6,1998,3560396,-6,6,0,73.34194276,1838.3,2010,83.43040186,-16.56959814,17.7468863,4.887238279,0.051750219,78550876,HDFC
1540,25-03-2019,1945.65,1976.9,1938.2,1976.9,3270882,-35.9,35.9,0,51.8741651,1838.55,2010,62.4671916,-37.5328084,16.40679788,7.1911502,0.025348476,75279994,HDFC
1541,26-03-2019,1946.3,1953.35,1930.85,1950.4,2621669,0.65,0,0.65,52.16666931,1858.8,2010,57.87037037,-42.12962963,15.22175086,8.797270331,0.008445596,77901663,HDFC
1542,27-03-2019,1919.9,1959,1906,1955.55,3076446,-26.4,26.4,0,40.60186478,1865.2,2010,37.77624309,-62.22375691,12.01384506,9.440585277,-0.015763976,74825217,HDFC
1543,28-03-2019,1944.45,1950,1912.05,1917,6370987,24.55,0,24.55,52.01587471,1871.1,2010,52.80777538,-47.19222462,11.32202319,9.81687286,-0.006387491,81196204,HDFC
1544,29-03-2019,1968.25,1972.25,1936.05,1950.05,4320179,23.8,0,23.8,60.50528925,1884,2010,66.86507937,-33.13492063,12.54954711,10.36340771,-0.003241081,85516383,HDFC
1545,01-04-2019,1959.65,1975,1945.05,1968.1,3328552,-8.6,8.6,0,56.34873253,1900.1,2010,54.18562329,-45.81437671,12.6822277,10.82717171,-0.001401345,82187831,HDFC
1546,02-04-2019,1995.95,2001,1955,1966.1,3655232,36.3,0,36.3,67.29206466,1906,2010,86.49038462,-13.50961538,15.53737942,11.76921325,0.014279544,85843063,HDFC
1547,03-04-2019,2013.1,2032.45,1997.15,2004,4345772,17.15,0,17.15,71.22465468,1906,2032.45,84.6975089,-15.3024911,18.96534866,13.20844033,0.012855023,90188835,HDFC
1548,04-04-2019,2042.05,2058.8,2006.3,2008,4463212,28.95,0,28.95,76.68472702,1906,2058.8,89.03795812,-10.96204188,23.74435193,15.31562265,0.030531655,94652047,HDFC
1549,05-04-2019,2059.2,2065,2035,2045,2576789,17.15,0,17.15,79.36154313,1906,2065,96.35220126,-3.647798742,28.58608552,17.96971522,0.058360959,97228836,HDFC
1550,08-04-2019,2054.9,2072.5,2029.25,2068,2057768,-4.3,4.3,0,76.81031203,1906,2072.5,89.42942943,-10.57057057,31.71067924,20.71790803,0.055798181,95171068,HDFC
1551,09-04-2019,2069.15,2073,2039.15,2062.5,2381281,14.25,0,14.25,79.34882184,1906,2073,97.69461078,-2.305389222,34.93409963,23.56114635,0.077738424,97552349,HDFC
1552,10-04-2019,2029.25,2068,2025.1,2067.5,3036356,-39.9,39.9,0,58.61784639,1906,2073,73.80239521,-26.19760479,33.87855606,25.62462829,0.043611304,94515993,HDFC
1553,11-04-2019,2022.8,2048,2017.5,2028,2521729,-6.45,6.45,0,55.89402058,1906,2073,69.94011976,-30.05988024,32.15095291,26.92989322,0.027714975,91994264,HDFC
1554,12-04-2019,2024.95,2029.9,2008.1,2024,2121821,2.15,0,2.15,56.66844739,1906,2073,71.22754491,-28.77245509,30.60253503,27.66442158,0.033322277,94116085,HDFC
1555,15-04-2019,2014.25,2034.9,2010,2034.9,1333222,-10.7,10.7,0,51.47807598,1906,2073,64.82035928,-35.17964072,28.18707902,27.76895307,0.009168566,92782863,HDFC
1556,16-04-2019,2026.7,2034.3,2016.1,2019.7,2000314,12.45,0,12.45,56.79134004,1912.05,2073,71.23330227,-28.76669773,26.96656985,27.60847642,0.00675575,94783177,HDFC
1557,18-04-2019,2003.75,2047.9,1998.15,2040,3888701,-22.95,22.95,0,46.06291343,1936.05,2073,49.43410004,-50.56589996,23.87224991,26.86123112,-0.018755662,90894476,HDFC
1558,22-04-2019,1953.9,2010,1948,2005,2002662,-49.85,49.85,0,31.26171,1945.05,2073,6.916764361,-93.08323564,17.19923856,24.92883261,-0.051136364,88891814,HDFC
1559,23-04-2019,1934.7,1966.25,1929.6,1958,2848980,-19.2,19.2,0,27.35535308,1929.6,2073,3.556485356,-96.44351464,10.24346911,21.99175991,-0.058494331,86042834,HDFC
1560,24-04-2019,1980.4,1985,1933.25,1943.9,2758373,45.7,0,45.7,45.91592888,1929.6,2073,35.42538354,-64.57461646,8.322641549,19.25793624,-0.042892009,88801207,HDFC
1561,25-04-2019,1955.15,1998.8,1946.55,1987.55,4162465,-25.25,25.25,0,39.48449888,1929.6,2073,17.81729428,-82.18270572,4.708629738,16.34807494,-0.036515954,84638742,HDFC
1562,26-04-2019,1977.4,1982.15,1941.6,1959.3,2094836,22.25,0,22.25,47.02851884,1929.6,2073,33.33333333,-66.66666667,3.598408179,13.79814159,-0.022444137,86733578,HDFC
1563,30-04-2019,1995.05,1999.85,1954.2,1977.4,3675345,17.65,0,17.65,52.45371433,1929.6,2073,45.64156206,-54.35843794,4.095546181,11.8576225,-0.014765797,90408923,HDFC
1564,02-05-2019,2017.4,2027.9,1989.25,1995,2380823,22.35,0,22.35,58.64253515,1929.6,2073,61.22733612,-38.77266388,6.221274858,10.73035298,0.001563858,92789746,HDFC
1565,03-05-2019,2006.4,2037.6,2000,2017.5,1451357,-11,11,0,54.60612113,1929.6,2068,55.49132948,-44.50867052,6.938341202,9.971950621,-0.010016283,91338389,HDFC
1566,06-05-2019,1965.45,1993.95,1957,1987.25,2216418,-40.95,40.95,0,42.14541992,1929.6,2048,30.27871622,-69.72128378,4.154409236,8.808442344,-0.019114161,89121971,HDFC
1567,07-05-2019,1966.3,2009.15,1959.2,1974.8,2683956,0.85,0,0.85,42.45989391,1929.6,2047.9,31.02282333,-68.97717667,1.993728531,7.445499581,0.006346282,91805927,HDFC
1568,08-05-2019,1930.75,1964.5,1925.05,1964.5,3626183,-35.55,35.55,0,33.63664951,1925.05,2047.9,4.63980464,-95.36019536,-2.557730467,5.444853572,-0.00204166,88179744,HDFC
1569,09-05-2019,1914.6,1931.6,1901.3,1926,1932792,-16.15,16.15,0,30.3326458,1901.3,2047.9,9.072305593,-90.92769441,-7.382859534,2.87931095,-0.033225611,86246952,HDFC
1570,10-05-2019,1931.7,1956,1910.75,1915.25,1628923,17.1,0,17.1,37.79728204,1901.3,2047.9,20.7366985,-79.2633015,-9.714993594,0.360450042,-0.011993965,87875875,HDFC
1571,13-05-2019,1952.9,1984.4,1917.85,1926.1,4509527,21.2,0,21.2,46.06420802,1901.3,2037.6,37.85766691,-62.14233309,-9.740283886,-1.659696744,-0.012390007,92385402,HDFC
1572,14-05-2019,1965.2,1989.8,1924.25,1961,4304854,12.3,0,12.3,50.47089614,1901.3,2037.6,46.88187821,-53.11812179,-8.667901249,-3.061337645,-0.014962031,96690256,HDFC
1573,15-05-2019,1944.95,1979.95,1937.5,1975,2371807,-20.25,20.25,0,43.69002663,1901.3,2037.6,32.02494497,-67.97505503,-9.344320537,-4.317934223,-0.035912561,94318449,HDFC
1574,16-05-2019,1942.1,1954,1923.3,1954,2527762,-2.85,2.85,0,42.75715705,1901.3,2037.6,29.93396919,-70.06603081,-9.995141112,-5.453375601,-0.032047448,91790687,HDFC
1575,17-05-2019,1993.65,1997.95,1938.55,1941,2328374,51.55,0,51.55,60.4027249,1901.3,2037.6,67.75495231,-32.24504769,-6.278887818,-5.618478044,0.014347859,94119061,HDFC
1576,20-05-2019,2122.5,2135.5,2030,2030.5,6214064,128.85,0,128.85,79.03834101,1901.3,2135.5,94.44918873,-5.550811272,6.982893399,-3.098203756,0.079438539,100333125,HDFC
1577,21-05-2019,2114.5,2178.9,2104.1,2141.2,5575430,-8,8,0,76.46042575,1901.3,2178.9,76.80115274,-23.19884726,16.65542406,0.852521807,0.095170271,94757695,HDFC
1578,22-05-2019,2138.8,2155.2,2119,2124,3076404,24.3,0,24.3,78.87525531,1901.3,2178.9,85.55475504,-14.44524496,25.98227373,5.878472191,0.117100178,97834099,HDFC
1579,23-05-2019,2114.4,2210,2103.3,2174,7619751,-24.4,24.4,0,70.49637261,1901.3,2210,69.03142209,-30.96857791,31.04710155,10.91219806,0.094579904,90214348,HDFC
1580,24-05-2019,2123.4,2151.9,2095,2125,3307188,9,0,9,71.77256834,1901.3,2210,71.94687399,-28.05312601,35.37940709,15.80563987,0.087306058,93521536,HDFC
1581,27-05-2019,2165.3,2187.5,2116.2,2129.95,3886480,41.9,0,41.9,77.09481598,1901.3,2210,85.51992225,-14.48007775,41.71292958,20.98709781,0.101821698,97408016,HDFC
1582,28-05-2019,2147.85,2169.75,2114,2167,7177003,-17.45,17.45,0,70.68994113,1901.3,2210,79.86718497,-20.13281503,44.80770727,25.7512197,0.104321448,90231013,HDFC
1583,29-05-2019,2147.45,2170,2135,2150.1,3085215,-0.4,0.4,0,70.53495162,1910.75,2210,79.09774436,-20.90225564,46.68985266,29.93894629,0.105736059,87145798,HDFC
1584,30-05-2019,2184.4,2189.45,2130,2141.4,3766742,36.95,0,36.95,76.11639923,1917.85,2210,91.23737806,-8.762621941,50.57996826,34.06715069,0.09567878,90912540,HDFC
1585,31-05-2019,2182.65,2197,2140.05,2190,5769576,-1.75,1.75,0,75.33653883,1923.3,2210,90.46041158,-9.53958842,52.91176858,37.83607427,0.028339223,85142964,HDFC
1586,03-06-2019,2230.45,2235,2192.7,2200,3673925,47.8,0,47.8,81.35660632,1923.3,2235,98.54026307,-1.459736927,57.94879997,41.85861941,0.054835659,88816889,HDFC
1587,04-06-2019,2223.95,2233.9,2209,2220,2430870,-6.5,6.5,0,78.35570759,1923.3,2235,96.45492461,-3.545075393,60.71628838,45.6301532,0.039812044,86386019,HDFC
1588,06-06-2019,2183.45,2231,2171.65,2230,3888312,-40.5,40.5,0,61.93223941,1938.55,2235,82.6108956,-17.3891044,58.96185578,48.29649372,0.032657019,82497707,HDFC
1589,07-06-2019,2210.85,2217.75,2168.4,2190,1951213,27.4,0,27.4,67.2850719,2030,2235,88.2195122,-11.7804878,59.10112533,50.45742004,0.04118395,84448920,HDFC
1590,10-06-2019,2194.05,2224.8,2175.45,2215.25,2484187,-16.8,16.8,0,61.1972128,2095,2235,70.75,-29.25,57.19655161,51.80524635,0.013277606,81964733,HDFC
1591,11-06-2019,2189.85,2204,2181,2202.25,2393325,-4.2,4.2,0,59.64061679,2095,2235,67.75,-32.25,54.71750894,52.38769887,0.019554438,79571408,HDFC
1592,12-06-2019,2181.95,2188.1,2162,2187.5,2223012,-7.9,7.9,0,56.52046513,2095,2235,62.10714286,-37.89285714,51.52147825,52.21445475,0.016065566,77348396,HDFC
1593,13-06-2019,2197.5,2200.8,2161.35,2180,2691171,15.55,0,15.55,61.13799763,2095,2235,73.21428571,-26.78571429,49.67078209,51.70572022,0.00599707,80039567,HDFC
1594,14-06-2019,2185.85,2207.55,2177.15,2204.5,2162503,-11.65,11.65,0,55.99715323,2114,2235,59.38016529,-40.61983471,46.72541294,50.70965876,0.001466108,77877064,HDFC
1595,17-06-2019,2173,2193,2164,2193,2058409,-12.85,12.85,0,50.58387383,2114,2235,48.76033058,-51.23966942,42.86023297,49.1397736,-0.025757134,75818655,HDFC
1596,18-06-2019,2153,2194.6,2134.65,2178.9,3405935,-20,20,0,43.10117333,2130,2235,21.9047619,-78.0952381,37.74808077,46.86143504,-0.031902696,72412720,HDFC
1597,19-06-2019,2175.4,2186.4,2158.55,2160.05,2146689,22.4,0,22.4,52.23269132,2130,2235,43.23809524,-56.76190476,35.09955035,44.5090581,-0.003686826,74559409,HDFC
1598,20-06-2019,2199.25,2207.7,2165.65,2174.1,2933451,23.85,0,23.85,60.09961635,2134.65,2235,64.37468859,-35.62531141,34.52706013,42.51265851,-0.005246851,77492860,HDFC
1599,21-06-2019,2140.8,2201.2,2135.9,2200.8,7764514,-58.45,58.45,0,41.00367536,2134.65,2235,6.128550075,-93.87144993,29.02237907,39.81460262,-0.024270185,69728346,HDFC
1600,24-06-2019,2148.9,2159,2133.5,2136.1,2038683,8.1,0,8.1,43.85613858,2133.5,2233.9,15.33864542,-84.66135458,25.02500925,36.85668394,-0.018699911,71767029,HDFC
1601,25-06-2019,2172.8,2176.8,2138.1,2147.9,1889368,23.9,0,23.9,51.79170071,2133.5,2231,40.30769231,-59.69230769,23.51453421,34.188254,-0.004193497,73656397,HDFC
1602,26-06-2019,2168.1,2180.6,2153.7,2165,2131272,-4.7,4.7,0,50.18226533,2133.5,2224.8,37.89704272,-62.10295728,21.68821292,31.68824578,-0.01337884,71525125,HDFC
1603,27-06-2019,2195.45,2202.55,2166.05,2166.5,3972522,27.35,0,27.35,58.78237049,2133.5,2224.8,67.85323111,-32.14676889,22.19194168,29.78898496,0.004391884,75497647,HDFC
1604,28-06-2019,2192.1,2205,2177.65,2196,2859385,-3.35,3.35,0,57.3823528,2133.5,2207.7,78.97574124,-21.02425876,22.06646488,28.24448095,0.008789692,72638262,HDFC
1605,01-07-2019,2245.9,2252.95,2192.3,2197,2090173,53.8,0,53.8,70.43189534,2133.5,2252.95,94.09794893,-5.902051067,26.00842505,27.79726977,0.043149094,74728435,HDFC
1606,02-07-2019,2281.25,2285,2240,2256.8,2729953,35.35,0,35.35,76.00275535,2133.5,2285,97.52475248,-2.475247525,31.62040609,28.56189703,0.048657718,77458388,HDFC
1607,03-07-2019,2277.2,2287,2257.2,2280,2146370,-4.05,4.05,0,74.15579586,2133.5,2287,93.61563518,-6.384364821,35.33383391,29.91628441,0.035443901,75312018,HDFC
1608,04-07-2019,2280.25,2286.3,2265.1,2277,1597337,3.05,0,3.05,74.69024779,2133.5,2287,95.60260586,-4.397394137,38.08385474,31.54979847,0.0651392,76909355,HDFC
1609,05-07-2019,2278.9,2300.7,2266.6,2281.25,1901409,-1.35,1.35,0,73.90964795,2133.5,2300.7,86.96172249,-13.03827751,39.69673312,33.1791854,0.060496068,75007946,HDFC
1610,08-07-2019,2259.95,2275.55,2243.3,2269.9,2638029,-18.95,18.95,0,63.20991128,2133.5,2300.7,75.62799043,-24.37200957,38.99631894,34.34261211,0.040109536,72369917,HDFC
1611,09-07-2019,2232.8,2248.85,2197.25,2248.85,2899589,-27.15,27.15,0,51.00367092,2133.5,2300.7,59.38995215,-40.61004785,35.83734692,34.64155907,0.029841797,69470328,HDFC
1612,10-07-2019,2227.75,2253.4,2220,2232,1544391,-5.05,5.05,0,48.97397247,2133.5,2300.7,56.36961722,-43.63038278,32.55111703,34.22347066,0.014712246,67925937,HDFC
1613,11-07-2019,2261.9,2269.3,2231.1,2240,1397362,34.15,0,34.15,61.06402901,2133.5,2300.7,76.79425837,-23.20574163,32.32969912,33.84471636,0.031841613,69323299,HDFC
1614,12-07-2019,2257.8,2282,2250.75,2270,2647206,-4.1,4.1,0,59.12342375,2138.1,2300.7,73.61623616,-26.38376384,31.4607284,33.36791876,0.005298544,66676093,HDFC
1615,15-07-2019,2265.35,2271,2236.4,2255.9,1570180,7.55,0,7.55,61.70901176,2153.7,2300.7,75.95238095,-24.04761905,31.02366327,32.89906767,-0.006969863,68246273,HDFC
1616,16-07-2019,2277.55,2284.8,2256.95,2270,2002416,12.2,0,12.2,65.74849039,2166.05,2300.7,82.80727813,-17.19272187,31.30090667,32.57943547,0.000153698,70248689,HDFC
1617,17-07-2019,2286.7,2289.45,2277,2277,1692841,9.15,0,9.15,68.61383078,2177.65,2300.7,88.62251117,-11.37748883,31.89132921,32.44181422,0.002828637,71941530,HDFC
1618,18-07-2019,2345.15,2357.85,2285.55,2287.95,4047413,58.45,0,58.45,80.58514762,2192.3,2357.85,92.32860163,-7.671398369,36.65315508,33.28408239,0.029071043,75988943,HDFC
1619,19-07-2019,2303.55,2339,2292.8,2332,3581265,-41.6,41.6,0,61.36417921,2197.25,2357.85,66.18929016,-33.81070984,36.64771204,33.95680832,0.019292462,72407678,HDFC
1620,22-07-2019,2186.9,2298,2180.2,2287,3007548,-116.65,116.65,0,34.63537699,2180.2,2357.85,3.771460737,-96.22853926,26.9203967,32.549526,-0.020557148,69400130,HDFC
1621,23-07-2019,2138.5,2189.75,2126.05,2181.4,4659229,-48.4,48.4,0,28.65904395,2126.05,2357.85,5.371009491,-94.62899051,15.13152689,29.06592618,-0.040062844,64740901,HDFC
1622,24-07-2019,2184.25,2188.85,2140,2140,3133303,45.75,0,45.75,39.95855501,2126.05,2357.85,25.1078516,-74.8921484,9.372366475,25.12721424,-0.034329546,67874204,HDFC
1623,25-07-2019,2195.35,2215.2,2161.3,2184.1,3194769,11.1,0,11.1,42.50778801,2126.05,2357.85,29.89646247,-70.10353753,5.638866245,21.22954464,-0.027659669,71068973,HDFC
1624,26-07-2019,2165.75,2197.8,2159.4,2193.75,1920114,-29.6,29.6,0,37.59622945,2126.05,2357.85,17.12683348,-82.87316652,0.288245082,17.04128473,-0.043966716,69148859,HDFC
1625,29-07-2019,2149,2174.95,2110,2162.8,1897861,-16.75,16.75,0,34.95881415,2110,2357.85,15.73532378,-84.26467622,-5.243304205,12.58436694,-0.05644223,67250998,HDFC
1626,30-07-2019,2127.25,2158.3,2113.35,2150,3091291,-21.75,21.75,0,31.63390772,2110,2357.85,6.959854751,-93.04014525,-11.2524291,7.817007732,-0.069729304,64159707,HDFC
1627,31-07-2019,2121.8,2131.95,2107.7,2110.25,3563574,-5.45,5.45,0,30.78730519,2107.7,2357.85,5.636618029,-94.36338197,-16.26695796,3.000214595,-0.095239111,60596133,HDFC
1628,01-08-2019,2086.8,2115.9,2063.8,2115.2,3634666,-35,35,0,25.69225575,2063.8,2357.85,7.821799014,-92.17820099,-22.80236424,-2.160301171,-0.094093899,56961467,HDFC
1629,02-08-2019,2124.8,2148.65,2039.35,2075.25,5907182,38,0,38,38.45229593,2039.35,2357.85,26.8288854,-73.1711146,-24.63150176,-6.654541288,-0.02839636,62868649,HDFC
1630,05-08-2019,2152.35,2159.45,2107.75,2115,6285106,27.55,0,27.55,46.18306713,2039.35,2357.85,35.47880691,-64.52119309,-23.58616504,-10.04086604,0.006476502,69153755,HDFC
1631,06-08-2019,2189.9,2217.65,2136.55,2146.05,5044712,37.55,0,37.55,55.06029599,2039.35,2357.85,47.26844584,-52.73155416,-19.50293923,-11.93328068,0.0025867,74198467,HDFC
1632,07-08-2019,2175.2,2198.95,2161.7,2189.8,3206138,-14.7,14.7,0,51.24224338,2039.35,2339,45.3362256,-54.6637744,-17.25422455,-12.99746945,-0.009178491,70992329,HDFC
1633,08-08-2019,2182.3,2187.7,2152,2183.9,3525820,7.1,0,7.1,53.05637547,2039.35,2298,55.26773632,-44.73226368,-14.72939994,-13.34385555,0.007641695,74518149,HDFC
1634,09-08-2019,2211.65,2240,2178.75,2192.7,4238315,29.35,0,29.35,60.13175821,2039.35,2240,85.87091951,-14.12908049,-10.24209406,-12.72350325,0.029153094,78756464,HDFC
1635,13-08-2019,2100.1,2209.65,2092.45,2196.1,3358448,-111.55,111.55,0,36.20276468,2039.35,2240,30.27660105,-69.72339895,-15.50825504,-13.28045361,-0.012762957,75398016,HDFC
1636,14-08-2019,2117.7,2146,2105.25,2129,2683820,17.6,0,17.6,40.51237646,2039.35,2240,39.0480937,-60.9519063,-18.05344379,-14.23505164,-0.001932322,78081836,HDFC
1637,16-08-2019,2100,2162,2092.5,2160,7231763,-17.7,17.7,0,37.56756281,2039.35,2240,30.22676302,-69.77323698,-21.2537661,-15.63879453,0.006325474,70850073,HDFC
1638,19-08-2019,2114.05,2135,2098.1,2114.45,2233119,14.05,0,14.05,41.46464292,2039.35,2240,37.22900573,-62.77099427,-22.39813524,-16.99066268,-0.0050593,73083192,HDFC
1639,20-08-2019,2090.1,2114.9,2075,2112.35,2966933,-23.95,23.95,0,36.93053601,2039.35,2240,25.29279841,-74.70720159,-24.95001266,-18.58253267,-0.028921876,70116259,HDFC
1640,21-08-2019,2066.9,2099.95,2062.95,2096,2095800,-23.2,23.2,0,32.90844774,2039.35,2240,13.73037628,-86.26962372,-28.51572845,-20.56917183,-0.056166948,68020459,HDFC
1641,22-08-2019,2014.1,2073.5,2007.95,2066,2424936,-52.8,52.8,0,25.589854,2007.95,2240,2.650290886,-97.34970911,-35.19638066,-23.49461359,-0.074062155,65595523,HDFC
1642,23-08-2019,2043.75,2058.05,1973,1999,3421089,29.65,0,29.65,34.96175586,1973,2240,26.49812734,-73.50187266,-37.66416936,-26.32852475,-0.063488063,69016612,HDFC
1643,26-08-2019,2148.35,2152.95,2060,2088,5267345,104.6,0,104.6,57.00476215,1973,2240,65.6741573,-34.3258427,-30.82424121,-27.22766804,-0.028621165,74283957,HDFC
1644,27-08-2019,2174.3,2186.75,2144.7,2158,7685979,25.95,0,25.95,60.80719815,1973,2240,75.39325843,-24.60674157,-23.04396426,-26.39092728,0.035331651,81969936,HDFC
1645,28-08-2019,2187.15,2193.6,2155.75,2174,3291574,12.85,0,12.85,62.69237803,1973,2240,80.20599251,-19.79400749,-15.66062518,-24.24486686,0.032795013,85261510,HDFC
1646,29-08-2019,2128.45,2179,2120.4,2176,5158203,-58.7,58.7,0,50.01266645,1973,2240,58.22097378,-41.77902622,-14.38011023,-22.27191554,0.013547619,80103307,HDFC
1647,30-08-2019,2166.45,2171.25,2118,2137.7,5191150,38,0,38,56.57328794,1973,2240,72.45318352,-27.54681648,-10.18164284,-19.853861,0.024786547,85294457,HDFC
1648,03-09-2019,2089.9,2144.7,2083,2141,4009112,-76.55,76.55,0,43.3489696,1973,2209.65,49.39784492,-50.60215508,-12.88276791,-18.45964238,-9.57E-05,81285345,HDFC
1649,04-09-2019,2100.1,2113.1,2072.7,2091.65,3621927,10.2,0,10.2,45.31431294,1973,2193.6,57.61559383,-42.38440617,-14.0385466,-17.57542322,0.016062703,84907272,HDFC
1650,05-09-2019,2044.15,2100,2040,2100,3847628,-55.95,55.95,0,37.15589159,1973,2193.6,32.25294651,-67.74705349,-19.24733564,-17.90980571,0.014919815,81059644,HDFC
1651,06-09-2019,2041.45,2056.45,2023,2056.45,4227171,-2.7,2.7,0,36.78710264,1973,2193.6,31.02901179,-68.97098821,-23.32433748,-18.99271206,-0.001125382,76832473,HDFC
1652,09-09-2019,2064.25,2069.95,2029,2044.45,2738878,22.8,0,22.8,42.3613121,1973,2193.6,41.36446056,-58.63553944,-24.43396185,-20.08096202,-0.039146322,79571351,HDFC
1653,11-09-2019,2071.85,2086.55,2053.1,2072,4003713,7.6,0,7.6,44.25205763,1973,2193.6,44.80961015,-55.19038985,-24.41860816,-20.94849125,-0.047118613,83575064,HDFC
1654,12-09-2019,2082.75,2113.85,2076.85,2085.45,3303127,10.9,0,10.9,47.12251185,1973,2193.6,49.75067996,-50.24932004,-23.25878851,-21.4105507,-0.047733352,86878191,HDFC
1655,13-09-2019,2083.85,2092.05,2063.7,2079,3133152,1.1,0,1.1,47.43765698,1973,2193.6,50.24932004,-49.75067996,-21.99729119,-21.5278988,-0.020954216,90011343,HDFC
1656,16-09-2019,2046.75,2083,2038,2080,3750174,-37.1,37.1,0,38.50657962,2023,2193.6,13.92145369,-86.07854631,-23.71780137,-21.96587931,-0.055251679,86261169,HDFC
1657,17-09-2019,1996.25,2045.5,1976.2,2041.9,5897097,-50.5,50.5,0,29.71882954,1976.2,2193.6,9.222631095,-90.77736891,-28.82398113,-23.33749968,-0.044810756,80364072,HDFC
1658,18-09-2019,1988.3,2012.4,1982.4,2010,4245697,-7.95,7.95,0,28.53590233,1976.2,2193.6,5.565777369,-94.43422263,-33.13025893,-25.29605153,-0.05323556,76118375,HDFC
1659,19-09-2019,1974.6,2002.3,1964.1,1988.3,4138284,-13.7,13.7,0,26.44304721,1964.1,2179,4.885993485,-95.11400651,-37.21944799,-27.68073082,-0.034023922,71980091,HDFC
1660,20-09-2019,2049.3,2065,1960,1983.9,18203636,74.7,0,74.7,49.66744544,1960,2171.25,42.27218935,-57.72781065,-34.04010098,-28.95260485,0.003845306,90183727,HDFC
1661,23-09-2019,2162,2194.8,2080,2085,9653408,112.7,0,112.7,67.5196714,1960,2194.8,86.0306644,-13.9693356,-22.17092482,-27.59626885,0.04735376,99837135,HDFC
1662,24-09-2019,2130,2185,2114.25,2159.9,4763968,-32,32,0,60.49049403,1960,2194.8,72.40204429,-27.59795571,-15.17175917,-25.11136691,0.028066704,95073167,HDFC
1663,25-09-2019,2069.95,2127.05,2050.25,2127.05,6966228,-60.05,60.05,0,49.36322375,1960,2194.8,46.82708688,-53.17291312,-14.30549823,-22.95019317,-0.006145721,88106939,HDFC
1664,26-09-2019,2063.2,2088,2053.8,2070.1,7669665,-6.75,6.75,0,48.21294309,1960,2194.8,43.95229983,-56.04770017,-14.00223968,-21.16060247,-0.009909542,80437274,HDFC
1665,27-09-2019,2035.9,2096.7,2025.6,2061.25,4896678,-27.3,27.3,0,43.48427023,1960,2194.8,32.3253833,-67.6746167,-15.78285204,-20.08505239,-0.005301087,75540596,HDFC
1666,30-09-2019,1977.05,2038.5,1970.05,2035.9,7117561,-58.85,58.85,0,34.95650307,1960,2194.8,7.261499148,-92.73850085,-21.69264404,-20.40657072,-0.009618034,68423035,HDFC
1667,01-10-2019,1995.65,2028.95,1962.95,1988,9472004,18.6,0,18.6,39.29782306,1960,2194.8,15.18313458,-84.81686542,-24.59185265,-21.24362711,0.003696625,77895039,HDFC
1668,03-10-2019,1974.55,1999,1951.25,1990,4882403,-21.1,21.1,0,36.14043001,1951.25,2194.8,9.566824061,-90.43317594,-28.26625424,-22.64815253,-2.53E-05,73012636,HDFC
1669,04-10-2019,1978.3,2016.9,1972.6,1992,7413858,3.75,0,3.75,37.17553798,1951.25,2194.8,11.10654896,-88.89345104,-30.52379105,-24.22328024,-0.034645977,80426494,HDFC
1670,07-10-2019,1969.3,1996.8,1963.05,1988.5,2730663,-9,9,0,35.57853096,1951.25,2194.8,7.411209197,-92.5887908,-32.66261572,-25.91114733,-0.089130435,77695831,HDFC
1671,09-10-2019,2002,2005,1964.35,1974.85,5119327,32.7,0,32.7,45.40994995,1951.25,2194.8,20.83761035,-79.16238965,-31.35756251,-27.00043037,-0.060093897,82815158,HDFC
1672,10-10-2019,1987.95,2000,1971,2000,2627395,-14.05,14.05,0,42.21592456,1951.25,2194.8,15.06877438,-84.93122562,-31.0985315,-27.82005059,-0.039614483,80187763,HDFC
1673,11-10-2019,2010.15,2025.5,1980.25,1997.95,2882644,22.2,0,22.2,48.78372417,1951.25,2194.8,24.1839458,-75.8160542,-28.77024758,-28.01008999,-0.025712485,83070407,HDFC
1674,14-10-2019,2014.75,2031.85,2000,2017,2903479,4.6,0,4.6,50.13868949,1951.25,2194.8,26.07267502,-73.92732498,-26.25127588,-27.65832717,-0.010388526,85973886,HDFC
1675,15-10-2019,2013.3,2030.4,2009.2,2019,2109065,-1.45,1.45,0,49.6608387,1951.25,2185,26.54545455,-73.45454545,-24.09423223,-26.94550818,0.018335399,83864821,HDFC
1676,16-10-2019,2048.7,2056,2015,2020,3766098,35.4,0,35.4,60.31518595,1951.25,2127.05,55.43230944,-44.56769056,-19.305731,-25.41755275,0.026582818,87630919,HDFC
1677,17-10-2019,2089.75,2095,2050.1,2056.95,4562240,41.05,0,41.05,69.07332613,1951.25,2096.7,95.22172568,-4.778274321,-12.05940404,-22.745923,0.058342407,92193159,HDFC
1678,18-10-2019,2094.45,2102,2065.1,2089,2760381,4.7,0,4.7,69.94946384,1951.25,2102,94.99170813,-5.008291874,-5.869724467,-19.3706833,0.058712025,94953540,HDFC
1679,22-10-2019,2114.9,2140.5,2096,2115,3460577,20.45,0,20.45,73.69127842,1951.25,2140.5,86.47291942,-13.52708058,0.677970064,-15.36095263,0.073934901,98414117,HDFC
1680,23-10-2019,2142.95,2148,2104.7,2116,2487332,28.05,0,28.05,78.02237823,1951.25,2148,97.43329098,-2.566709022,8.03781085,-10.68119993,0.070404595,100901449,HDFC
1681,24-10-2019,2144.95,2174.2,2141.35,2150,4061508,2,0,2,78.31606313,1951.25,2174.2,86.88046647,-13.11953353,13.87201305,-5.770557334,0.078975829,104962957,HDFC
1682,25-10-2019,2101.55,2153.45,2085.25,2149,3099190,-43.4,43.4,0,58.68188861,1963.05,2174.2,65.5931802,-34.4068198,14.82277531,-1.651890805,0.045469244,101863767,HDFC
1683,27-10-2019,2105.35,2120,2096.8,2114.95,280920,3.8,0,3.8,59.70254875,1963.05,2174.2,67.39284869,-32.60715131,15.7018879,1.818864937,0.044968358,102144687,HDFC
1684,29-10-2019,2113.05,2123.55,2079.05,2095,2732339,7.7,0,7.7,61.90287906,1964.35,2174.2,70.86013819,-29.13986181,16.82595745,4.82028344,0.049545522,104877026,HDFC
1685,30-10-2019,2107.45,2134.95,2102.6,2134.95,2347585,-5.6,5.6,0,59.19075596,1971,2174.2,67.15059055,-32.84940945,17.06816627,7.269860007,0.028676722,102529441,HDFC
1686,31-10-2019,2131.9,2146.8,2103.65,2115,3273126,24.45,0,24.45,66.56946826,1980.25,2174.2,78.19025522,-21.80974478,19.01384935,9.618657875,0.020169877,105802567,HDFC
1687,01-11-2019,2128.6,2167.25,2120.1,2135.9,3431044,-3.3,3.3,0,64.7463277,2000,2174.2,73.82319173,-26.17680827,20.05831502,11.7065893,0.016304997,102371523,HDFC
1688,04-11-2019,2181.3,2195,2121.1,2140.9,6580464,52.7,0,52.7,76.5701728,2009.2,2195,92.62648009,-7.373519914,24.85203239,14.33567792,0.031396284,108951987,HDFC
1689,05-11-2019,2181.3,2209.8,2164.7,2207.1,5525743,0,0,0,76.5701728,2015,2209.8,85.36960986,-14.63039014,28.32457982,17.1334583,0.017895891,108951987,HDFC
1690,06-11-2019,2220.6,2228,2162,2188,4225289,39.3,0,39.3,82.42311291,2050.1,2228,95.84035975,-4.159640247,33.85749214,20.47826507,0.035268887,113177276,HDFC
1691,07-11-2019,2251,2264.8,2236.2,2247.4,5582130,30.4,0,30.4,85.62762838,2065.1,2264.8,93.08963445,-6.910365548,40.23162582,24.42893722,0.071114178,118759406,HDFC
1692,08-11-2019,2233.2,2252.5,2211,2242.95,3315622,-17.8,17.8,0,76.23727185,2079.05,2264.8,82.98788694,-17.01211306,43.34718211,28.2125862,0.060726245,115443784,HDFC
1693,11-11-2019,2234.55,2239.8,2216,2228,1834680,1.35,0,1.35,76.46315204,2079.05,2264.8,83.71467026,-16.28532974,45.40185234,31.65043942,0.057499823,117278464,HDFC
1694,13-11-2019,2207.45,2231.95,2195.45,2227.95,2791867,-27.1,27.1,0,62.66579705,2079.05,2264.8,69.12516824,-30.87483176,44.33241331,34.1868342,0.047450711,114486597,HDFC
1695,14-11-2019,2226.8,2232.85,2190.2,2207.9,1953996,19.35,0,19.35,67.49769146,2079.05,2264.8,79.54239569,-20.45760431,44.5329108,36.25604952,0.044514283,116440593,HDFC
1696,15-11-2019,2224.05,2238.75,2208,2220.1,3346325,-2.75,2.75,0,66.09494738,2079.05,2264.8,78.06191117,-21.93808883,43.96312494,37.79746461,0.04484168,113094268,HDFC
1697,18-11-2019,2236.3,2240.85,2210,2222.5,2249585,12.25,0,12.25,69.3670686,2079.05,2264.8,84.65679677,-15.34320323,43.99291522,39.03655473,0.025214322,115343853,HDFC
1698,19-11-2019,2212.1,2238.75,2202.2,2235.6,2916866,-24.2,24.2,0,56.85897383,2102.6,2264.8,67.50924784,-32.49075216,41.5844271,39.5461292,0.01412002,112426987,HDFC
1699,20-11-2019,2200.95,2221,2193.75,2215,1772677,-11.15,11.15,0,51.88517188,2103.65,2264.8,60.37852932,-39.62147068,38.33407968,39.3037193,-0.00884896,110654310,HDFC
1700,21-11-2019,2210.35,2216,2186.2,2202,2679074,9.4,0,9.4,55.65830922,2120.1,2264.8,62.37042156,-37.62957844,36.10051313,38.66307806,-0.018058641,113333384,HDFC
1701,22-11-2019,2237.3,2240,2199.3,2203,2186207,26.95,0,26.95,64.79195906,2121.1,2264.8,80.86290884,-19.13709116,36.08902352,38.14826716,0.001835931,115519591,HDFC
1702,25-11-2019,2294.55,2297,2227.4,2244.75,4535037,57.25,0,57.25,76.6042423,2162,2297,98.18518519,-1.814814815,40.23570233,38.56575419,0.026851044,120054628,HDFC
1703,26-11-2019,2304.65,2320,2280.95,2300,8808006,10.1,0,10.1,78.09989893,2162,2320,90.28481013,-9.715189873,43.83169625,39.6189426,0.044032707,128862634,HDFC
1704,27-11-2019,2336.3,2352,2308.4,2316,5748946,31.65,0,31.65,82.21167987,2186.2,2352,90.53075995,-9.469240048,48.67435021,41.43002412,0.049173702,134611580,HDFC
1705,28-11-2019,2309.75,2346,2295,2339,3668406,-26.55,26.55,0,69.56902001,2186.2,2352,74.51749095,-25.48250905,49.79581015,43.10318133,0.038533306,130943174,HDFC
1706,29-11-2019,2297.25,2316.35,2280.1,2309.75,3027045,-12.5,12.5,0,64.2052646,2186.2,2352,66.97828709,-33.02171291,49.10982224,44.30450951,0.027254841,127916129,HDFC
1707,02-12-2019,2306.6,2316,2263.9,2316,4044191,9.35,0,9.35,66.43854554,2186.2,2352,72.61761158,-27.38238842,48.75858018,45.19532364,0.042719588,131960320,HDFC
1708,03-12-2019,2319.7,2325,2287.05,2310.95,2402354,13.1,0,13.1,69.51350433,2186.2,2352,80.51869723,-19.48130277,48.97275144,45.9508092,0.053953974,134362674,HDFC
1709,04-12-2019,2322.4,2328.7,2286.4,2311.2,3205622,2.7,0,2.7,70.16361179,2186.2,2352,82.14716526,-17.85283474,48.79784001,46.52021536,0.050693329,137568296,HDFC
1710,05-12-2019,2327.55,2333.55,2300,2309.2,2623207,5.15,0,5.15,71.50112103,2186.2,2352,85.25331725,-14.74668275,48.51552662,46.91927761,0.040338801,140191503,HDFC
1711,06-12-2019,2264.65,2335,2246.45,2326.5,3440155,-62.9,62.9,0,43.81880602,2186.2,2352,47.31604343,-52.68395657,42.7237936,46.08018081,-0.013030878,136751348,HDFC
1712,09-12-2019,2311.4,2315.45,2260.05,2263.1,3361967,46.75,0,46.75,57.82266109,2186.2,2352,75.51266586,-24.48733414,41.42857492,45.14985963,0.002928861,140113315,HDFC
1713,10-12-2019,2295.15,2332.9,2288.15,2318.5,2693998,-16.25,16.25,0,52.56741651,2186.2,2352,65.71170084,-34.28829916,38.64538565,43.84896484,-0.01761332,137419317,HDFC
1714,11-12-2019,2321.65,2328.25,2292.7,2302,2582138,26.5,0,26.5,59.49448432,2199.3,2352,80.12442698,-19.87557302,38.13838111,42.70684809,0.005152073,140001455,HDFC
1715,12-12-2019,2318.45,2327,2303,2320.8,2503363,-3.2,3.2,0,58.3080246,2227.4,2352,73.07383628,-26.92616372,37.05125925,41.57573032,0.009228425,137498092,HDFC
1716,13-12-2019,2354.5,2365.95,2318.1,2330.7,2557242,36.05,0,36.05,66.89080677,2246.45,2365.95,90.41841004,-9.581589958,38.6530725,40.99119876,0.020766496,140055334,HDFC
1717,16-12-2019,2375.25,2384,2343,2356,3510250,20.75,0,20.75,70.87307891,2246.45,2384,93.63867684,-6.361323155,41.1228342,41.01752585,0.023947062,143565584,HDFC
1718,17-12-2019,2430.1,2436.55,2359.4,2365,7277994,54.85,0,54.85,78.69048062,2246.45,2436.55,96.60704892,-3.392951078,46.96469496,42.20695967,0.04637444,150843578,HDFC
1719,18-12-2019,2445.15,2459.3,2415.8,2427,5100244,15.05,0,15.05,80.35938235,2246.45,2459.3,93.35212591,-6.64787409,52.20701101,44.20696994,0.05052523,155943822,HDFC
1720,19-12-2019,2411.9,2438.5,2405.65,2432.1,4116736,-33.25,33.25,0,66.98592424,2246.45,2459.3,77.73079634,-22.26920366,53.06686533,45.97894902,0.065021085,151827086,HDFC
1721,20-12-2019,2404.1,2425,2378.15,2415,5053198,-7.8,7.8,0,64.09853016,2246.45,2459.3,74.06624383,-25.93375617,52.51356754,47.28587272,0.040105564,146773888,HDFC
1722,23-12-2019,2422.65,2433.8,2390,2404,1976677,18.55,0,18.55,67.89587911,2246.45,2459.3,82.78130139,-17.21869861,52.961399,48.42097798,0.055551925,148750565,HDFC
1723,24-12-2019,2412.75,2444.95,2402.95,2420.6,2813782,-9.9,9.9,0,63.74398134,2246.45,2459.3,78.1301386,-21.8698614,51.9189718,49.12057674,0.039239334,145936783,HDFC
1724,26-12-2019,2414.1,2433.35,2404.3,2412.75,1480323,1.35,0,1.35,64.08949974,2246.45,2459.3,78.76438807,-21.23561193,50.61827844,49.42011708,0.041256012,147417106,HDFC
1725,27-12-2019,2444.15,2449.55,2418.55,2427,2080901,30.05,0,30.05,71.15078393,2260.05,2459.3,92.39648683,-7.603513174,51.41952122,49.81999791,0.038076025,149498007,HDFC
1726,30-12-2019,2438.25,2450,2421.5,2449,1920751,-5.9,5.9,0,68.11640779,2288.15,2459.3,87.70084721,-12.29915279,50.99064281,50.05412689,0.026523524,147577256,HDFC
1727,31-12-2019,2412.55,2435,2406.55,2433,2260375,-25.7,25.7,0,56.09300378,2292.7,2459.3,71.93877551,-28.06122449,48.02339456,49.64798042,-0.007221925,145316881,HDFC
1728,01-01-2020,2433.95,2438.5,2409,2418,945874,21.4,0,21.4,62.45954798,2303,2459.3,83.78119002,-16.21880998,46.85847478,49.09007929,-0.004580496,146262755,HDFC
1729,02-01-2020,2466.4,2472.75,2422,2430,1701396,32.45,0,32.45,70.05624947,2318.1,2472.75,95.89395409,-4.10604591,48.00039261,48.87214196,0.022596293,147964151,HDFC
1730,03-01-2020,2454.45,2466.4,2441.8,2455,1963923,-11.95,11.95,0,64.50936122,2343,2472.75,85.89595376,-14.10404624,47.3947682,48.57666721,0.020943388,146000228,HDFC
1731,06-01-2020,2384.1,2445,2371.4,2428,2656731,-70.35,70.35,0,41.94825009,2359.4,2472.75,21.7909131,-78.2090869,40.76819902,47.01497357,-0.015912327,143343497,HDFC
1732,07-01-2020,2415.05,2428.8,2380.2,2401.25,3771992,30.95,0,30.95,50.70058568,2371.4,2472.75,43.06857425,-56.93142575,37.58079354,45.12813756,0.000953269,147115489,HDFC
1733,08-01-2020,2406.15,2413,2385.5,2387,2147334,-8.9,8.9,0,48.28512874,2371.4,2472.75,34.28712383,-65.71287617,33.94529587,42.89156922,-0.003293153,144968155,HDFC
1734,09-01-2020,2457.4,2462.7,2421.15,2430,3247323,51.25,0,51.25,60.71931016,2371.4,2472.75,84.85446473,-15.14553527,34.7984496,41.2729453,0.005421108,148215478,HDFC
1735,10-01-2020,2457.55,2477.65,2440.3,2465,2082060,0.15,0,0.15,60.75117954,2371.4,2477.65,81.08235294,-18.91764706,35.08227717,40.03481167,0.007915513,150297538,HDFC
1736,13-01-2020,2462.55,2471.05,2441,2461.1,3401754,5,0,5,61.93886897,2371.4,2477.65,85.78823529,-14.21176471,35.30371157,39.08859165,0.020724959,153699292,HDFC
1737,14-01-2020,2492.3,2499.9,2446.6,2463.65,2549328,29.75,0,29.75,68.48592079,2371.4,2499.9,94.08560311,-5.914396887,37.44809793,38.76049291,0.023973377,156248620,HDFC
1738,15-01-2020,2488.6,2495,2453.55,2483.95,2279961,-3.7,3.7,0,66.836096,2371.4,2499.9,91.20622568,-8.793774319,38.40625707,38.68964574,0.009000973,153968659,HDFC
1739,16-01-2020,2482.1,2495.75,2471.8,2486,1794295,-6.5,6.5,0,63.72436819,2371.4,2499.9,86.14785992,-13.85214008,38.20075489,38.59186757,0.011265253,152174364,HDFC
1740,17-01-2020,2453.95,2479,2448.25,2467.75,2250437,-28.15,28.15,0,51.69704017,2371.4,2499.9,64.24124514,-35.75875486,35.35882862,37.94525978,0.029298268,149923927,HDFC
1741,20-01-2020,2454.35,2486.55,2440.4,2474,2274456,0.4,0,0.4,51.84605346,2371.4,2499.9,64.55252918,-35.44747082,32.76120743,36.90844931,0.016272955,152198383,HDFC
1742,21-01-2020,2465.45,2485.9,2432,2443,2404025,11.1,0,11.1,56.17501683,2371.4,2499.9,73.19066148,-26.80933852,31.23815713,35.77439087,0.02464518,154602408,HDFC
1743,22-01-2020,2416.6,2483.35,2412.2,2474,3356004,-48.85,48.85,0,38.56847708,2371.4,2499.9,35.17509728,-64.82490272,25.79202761,33.77791822,-0.016602914,151246404,HDFC
1744,23-01-2020,2428.4,2436.4,2404.35,2422,1812646,11.8,0,11.8,43.50379801,2371.4,2499.9,44.35797665,-55.64202335,22.17250131,31.45683484,-0.011861407,153059050,HDFC
1745,24-01-2020,2450.75,2458.6,2411.4,2423,2178412,22.35,0,22.35,51.94172433,2380.2,2499.9,58.9390142,-41.0609858,20.86691802,29.33885148,-0.004791781,155237462,HDFC
1746,27-01-2020,2395.8,2445,2388.5,2433,2543177,-54.95,54.95,0,36.48371397,2385.5,2499.9,9.003496503,-90.9965035,15.22274971,26.51563112,-0.038719255,152694285,HDFC
1747,28-01-2020,2431.6,2471.7,2410,2413,6698252,35.8,0,35.8,48.09564104,2388.5,2499.9,38.68940754,-61.31059246,13.48304234,23.90911337,-0.022904444,159392537,HDFC
1748,29-01-2020,2404.25,2447.5,2400,2446,2692713,-27.35,27.35,0,41.42054891,2388.5,2499.9,14.13824057,-85.86175943,9.784604467,21.08421159,-0.03136457,156699824,HDFC
1749,30-01-2020,2415,2428.7,2386.9,2413,2807667,10.75,0,10.75,44.88940052,2386.9,2499.9,24.86725664,-75.13274336,7.633012348,18.39397174,-0.015872369,159507491,HDFC
1750,31-01-2020,2414,2434.75,2404.5,2417,2828509,-1,1,0,44.60588812,2386.9,2499.9,23.98230088,-76.01769912,5.780534052,15.8712842,-0.016440198,156678982,HDFC
1751,01-02-2020,2268.25,2422.7,2252.75,2406,3906937,-145.75,145.75,0,21.63079697,2252.75,2495.75,6.378600823,-93.62139918,-7.363493492,11.22432866,-0.079985398,152772045,HDFC
1752,03-02-2020,2259.75,2298.05,2228.2,2250,5220749,-8.5,8.5,0,20.90619692,2228.2,2495.75,11.79218838,-88.20781162,-18.25566899,5.328329132,-0.064905239,147551296,HDFC
1753,04-02-2020,2345.95,2351,2265.6,2265.6,3288687,86.2,0,86.2,43.17885555,2228.2,2486.55,45.57770466,-54.42229534,-19.70502964,0.321657378,-0.033952397,150839983,HDFC
1754,05-02-2020,2391.65,2395.5,2326.2,2345.55,3244383,45.7,0,45.7,51.5285807,2228.2,2486.55,63.26688601,-36.73311399,-16.97042582,-3.136759261,-0.024115067,154084366,HDFC
1755,06-02-2020,2436.45,2447.8,2369.65,2390,3536393,44.8,0,44.8,58.43700167,2228.2,2485.9,80.81102057,-19.18897943,-11.06074561,-4.72155653,0.016967193,157620759,HDFC
1756,07-02-2020,2405.65,2452.3,2398.35,2428.1,2193190,-30.8,30.8,0,52.50115684,2228.2,2483.35,69.5473251,-30.4526749,-8.761585947,-5.529562413,-0.010671986,155427569,HDFC
1757,10-02-2020,2414.3,2425.3,2391.05,2405,2056525,8.65,0,8.65,54.0148084,2228.2,2471.7,76.42710472,-23.57289528,-6.170374408,-5.657724812,0.004180098,157484094,HDFC
1758,11-02-2020,2435.15,2441.75,2420.2,2424.45,1732762,20.85,0,20.85,57.75865842,2228.2,2471.7,84.98973306,-15.01026694,-2.406657397,-5.007511329,0.008343685,159216856,HDFC
1759,12-02-2020,2437.6,2487,2427.9,2449.5,4173099,2.45,0,2.45,58.21984684,2228.2,2487,80.91190108,-19.08809892,0.764991627,-3.853010738,0.009776305,163389955,HDFC
1760,13-02-2020,2403.65,2444.15,2399,2426,2280271,-33.95,33.95,0,49.56706926,2228.2,2487,67.79366306,-32.20633694,0.53292187,-2.975824217,0.059693596,161109684,HDFC
1761,14-02-2020,2401.75,2425.85,2389.4,2402,2611510,-1.9,1.9,0,49.09588444,2228.2,2487,67.05950541,-32.94049459,0.193460699,-2.341967233,0.06283881,158498174,HDFC
1762,17-02-2020,2350.25,2406.65,2345.15,2401.75,2398556,-51.5,51.5,0,37.84457189,2228.2,2487,47.15996909,-52.84003091,-4.182965696,-2.710166926,0.001832946,156099618,HDFC
1763,18-02-2020,2318.8,2349,2304,2349,2345063,-31.45,31.45,0,32.58305227,2228.2,2487,35.00772798,-64.99227202,-10.07295258,-4.182724056,-0.030460143,153754555,HDFC
1764,19-02-2020,2377.25,2385,2330.05,2343,2088724,58.45,0,58.45,48.06648049,2228.2,2487,57.5927357,-42.4072643,-9.910145121,-5.328208269,-0.024297646,155843279,HDFC
1765,20-02-2020,2369.5,2377.5,2349.05,2364,3351611,-7.75,7.75,0,46.43490311,2228.2,2487,54.59814529,-45.40185471,-10.28788691,-6.320143998,-0.015027124,152491668,HDFC
1766,24-02-2020,2292.3,2365.2,2280.1,2355,4238039,-77.2,77.2,0,33.40285994,2265.6,2487,12.0596206,-87.9403794,-16.62500214,-8.381115626,-0.050532245,148253629,HDFC
1767,25-02-2020,2302.6,2320.75,2285,2309,3292922,10.3,0,10.3,36.16103383,2280.1,2487,10.87481875,-89.12518125,-20.57886732,-10.82066597,-0.054431965,151546551,HDFC
1768,26-02-2020,2281.45,2309.5,2253.55,2278,6163133,-21.15,21.15,0,32.92974699,2253.55,2487,11.95116727,-88.04883273,-25.12928742,-13.68239026,-0.06405891,145383418,HDFC
1769,27-02-2020,2272.2,2289.6,2244.55,2279.8,3261885,-9.25,9.25,0,31.50890041,2244.55,2487,11.40441328,-88.59558672,-29.14594947,-16.7751021,-0.054687663,142121533,HDFC
1770,28-02-2020,2175.75,2228.55,2162.3,2228.55,7715143,-96.45,96.45,0,20.74155716,2162.3,2487,4.142285186,-95.85771481,-39.65477644,-21.35103697,-0.094098054,134406390,HDFC
1771,02-03-2020,2179.65,2248.35,2153.8,2215,3957634,3.9,0,3.9,21.98538864,2153.8,2487,7.758103241,-92.24189676,-47.12517048,-26.50586367,-0.072588023,138364024,HDFC
1772,03-03-2020,2191.4,2226.9,2173.3,2201.7,4229070,11.75,0,11.75,26.02131981,2153.8,2487,11.28451381,-88.71548619,-51.50368239,-31.50542741,-0.054942211,142593094,HDFC
1773,04-03-2020,2206.05,2216.6,2180.2,2207,4460096,14.65,0,14.65,31.145757,2153.8,2444.15,17.99552265,-82.00447735,-53.17854292,-35.84005052,-0.072015985,147053190,HDFC
1774,05-03-2020,2195.05,2232.2,2183,2206,3916762,-11,11,0,29.3824399,2153.8,2425.85,15.16265392,-84.83734608,-54.76222518,-39.62448545,-0.073623127,143136428,HDFC
1775,06-03-2020,2109.45,2145,2092.8,2145,5414446,-85.6,85.6,0,19.47989037,2092.8,2406.65,5.305082046,-94.69491795,-62.20742097,-44.14107255,-0.079767046,137721982,HDFC
1776,09-03-2020,2027.9,2067.3,1981.2,2067.3,5051322,-81.55,81.55,0,14.21398433,1981.2,2385,11.56513125,-88.43486875,-73.8370482,-50.08026768,-0.119299922,132670660,HDFC
1777,11-03-2020,2036.25,2073.85,1970,1970,6997019,8.35,0,8.35,16.86895812,1970,2385,15.96385542,-84.03614458,-81.4410348,-56.35242111,-0.107475509,139667679,HDFC
1778,12-03-2020,1875.7,1990,1861.1,1990,8837533,-160.55,160.55,0,10.00164436,1861.1,2377.5,2.827265686,-97.17273431,-99.2778786,-64.9375126,-0.174500484,130830146,HDFC
1779,13-03-2020,2066.8,2123.7,1688.15,1780.05,14173637,191.1,0,191.1,42.2757975,1688.15,2365.2,55.92644561,-44.07355439,-96.87679749,-71.32536958,-0.050074687,145003783,HDFC
1780,16-03-2020,1841.75,1979.5,1825,1964,10672843,-225.05,225.05,0,28.42473814,1688.15,2320.75,24.28074613,-75.71925387,-111.8443061,-79.42915688,-0.155024889,134330940,HDFC
1781,17-03-2020,1755.8,1869.9,1740,1858.05,6682574,-85.95,85.95,0,24.83855634,1688.15,2309.5,10.88758349,-89.11241651,-129.1528178,-89.37388907,-0.198777038,127648366,HDFC
1782,18-03-2020,1622.55,1784.7,1602.4,1771,9070671,-133.25,133.25,0,20.26502021,1602.4,2289.6,2.932188591,-97.06781141,-151.8714203,-101.8733953,-0.264499898,118577695,HDFC
1783,19-03-2020,1617.6,1703.95,1490.1,1502.1,11254232,-4.95,4.95,0,20.10633206,1490.1,2248.35,16.81503462,-83.18496538,-168.3350385,-115.1657239,-0.263069178,107323463,HDFC
1784,20-03-2020,1753.95,1776.9,1535.2,1624,11377225,136.35,0,136.35,36.02790249,1490.1,2248.35,34.79723046,-65.20276954,-168.4386136,-125.8203019,-0.168527341,118700688,HDFC
1785,23-03-2020,1520.7,1673.25,1500,1578.6,9474584,-233.25,233.25,0,25.856889,1490.1,2232.2,4.1234335,-95.8765665,-185.2070714,-137.6976558,-0.250110952,109226104,HDFC
1786,24-03-2020,1505.1,1649.7,1473.45,1554,8900025,-15.6,15.6,0,25.30558334,1473.45,2232.2,4.171334432,-95.82866557,-197.4785746,-149.6538396,-0.260847145,100326079,HDFC
1787,25-03-2020,1646.05,1655.6,1476,1476,10417560,140.95,0,140.95,38.88938237,1473.45,2232.2,22.74794069,-77.25205931,-193.5986574,-158.4428031,-0.122434291,110743639,HDFC
1788,26-03-2020,1733.25,1843.45,1671.2,1689.5,12104359,87.2,0,87.2,45.91106004,1473.45,2145,38.6866205,-61.3133795,-181.3964584,-163.0335342,-0.161384749,122847998,HDFC
1789,27-03-2020,1754,1849.65,1710.05,1785.2,9048464,20.75,0,20.75,47.56527791,1473.45,2123.7,43.14494425,-56.85505575,-168.1138643,-164.0496002,-0.047644903,131896462,HDFC
1790,30-03-2020,1558.75,1699,1548,1667.3,8670691,-195.25,195.25,0,35.70829484,1473.45,2123.7,13.11803153,-86.88196847,-171.3669444,-165.513069,-0.112228044,123225771,HDFC
1791,31-03-2020,1633.1,1666.55,1582,1625,10444821,74.35,0,74.35,42.05486358,1473.45,2123.7,24.55209535,-75.44790465,-166.0317002,-165.6167953,0.006502111,133670592,HDFC
1792,01-04-2020,1583.5,1693.6,1575.9,1645.5,6752017,-49.6,49.6,0,39.08496015,1473.45,2123.7,16.9242599,-83.0757401,-163.9162615,-165.2766885,-0.021080613,126918575,HDFC
1793,03-04-2020,1499.55,1578.8,1482.25,1575.5,10149442,-83.95,83.95,0,34.34785859,1473.45,1979.5,5.157593123,-94.84240688,-167.0877411,-165.638899,-0.145044043,116769133,HDFC
1794,07-04-2020,1555.15,1577.5,1517.6,1574.7,12307166,55.6,0,55.6,39.91310951,1473.45,1869.9,20.60789507,-79.39210493,-163.2330571,-165.1577306,0.022654041,129076299,HDFC
1795,08-04-2020,1558.8,1692,1535,1543.4,8974987,3.65,0,3.65,40.29646517,1473.45,1849.65,22.68740032,-77.31259968,-158.0616316,-163.7385108,0.035678692,138051286,HDFC
1796,09-04-2020,1703.1,1714.65,1587.5,1587.7,8572034,144.3,0,144.3,53.75525259,1473.45,1849.65,61.0446571,-38.9553429,-140.6975618,-159.130321,0.034658728,146623320,HDFC
1797,13-04-2020,1655.2,1763.75,1646.55,1725,7287804,-47.9,47.9,0,49.48280007,1473.45,1849.65,48.31206805,-51.68793195,-129.3109251,-153.1664419,-0.045031011,139335516,HDFC
1798,15-04-2020,1596.3,1710,1584.9,1708.5,8512332,-58.9,58.9,0,44.46822829,1473.45,1849.65,32.65550239,-67.34449761,-123.6147178,-147.256097,-0.08990878,130823184,HDFC
1799,16-04-2020,1625.75,1663.7,1575,1590,7892749,29.45,0,29.45,47.53557197,1473.45,1849.65,40.48378522,-59.51621478,-115.3938748,-140.8836526,0.04298316,138715933,HDFC
1800,17-04-2020,1680.6,1738,1652.4,1690,8954559,54.85,0,54.85,53.10243394,1476,1849.65,54.75712565,-45.24287435,-103.2625149,-133.3594251,0.029085788,147670492,HDFC
1801,20-04-2020,1727.7,1738,1673.4,1709.8,7372380,47.1,0,47.1,57.56385875,1482.25,1849.65,66.8072945,-33.1927055,-88.82384246,-124.4523085,0.091064099,155042872,HDFC
1802,21-04-2020,1669.7,1694.8,1651.1,1670,6604554,-58,58,0,50.70948936,1482.25,1849.65,51.0206859,-48.9793141,-81.12603536,-115.7870539,0.113467374,148438318,HDFC
1803,22-04-2020,1664.15,1679,1626.15,1669.7,5301750,-5.55,5.55,0,50.05145704,1482.25,1763.75,64.61811723,-35.38188277,-74.61321173,-107.5522855,0.070089702,143136568,HDFC
1804,23-04-2020,1663.45,1687,1651.6,1674.9,4419421,-0.7,0.7,0,49.95711434,1482.25,1763.75,64.36944938,-35.63055062,-68.71611957,-99.78505229,0.067134976,138717147,HDFC
1805,24-04-2020,1580.3,1624.95,1569.1,1603,7166440,-83.15,83.15,0,39.70058175,1482.25,1763.75,34.8312611,-65.1687389,-69.94584943,-93.81721172,-0.072103811,131550707,HDFC
1806,27-04-2020,1591.45,1652.15,1585.35,1618.1,5719079,11.15,0,11.15,41.55708457,1482.25,1763.75,38.79218472,-61.20781528,-69.22275061,-88.89831949,-0.038514983,137269786,HDFC
1807,28-04-2020,1715.8,1725,1612.65,1615.8,7691600,124.35,0,124.35,58.14108464,1517.6,1763.75,80.52000813,-19.47999187,-57.94769881,-82.70819536,0.074860615,144961386,HDFC
1808,29-04-2020,1836.75,1845,1726,1734,11881509,120.95,0,120.95,68.25184646,1535,1845,97.33870968,-2.661290323,-38.80516309,-73.92758891,0.129786252,156842895,HDFC
1809,30-04-2020,1916,1927,1855.5,1857,8237079,79.25,0,79.25,73.1542853,1569.1,1927,96.92651579,-3.073484213,-17.04328852,-62.55072883,0.140069023,165079974,HDFC
1810,04-05-2020,1724.35,1856,1708.3,1856,6040202,-191.65,191.65,0,51.12556416,1569.1,1927,43.37803856,-56.62196144,-15.08748036,-53.05807914,-0.001938994,159039772,HDFC
1811,05-05-2020,1689.9,1769.5,1678,1745,7807204,-34.45,34.45,0,48.12014695,1569.1,1927,33.75244482,-66.24755518,-16.13136309,-45.67273593,0.012097982,151232568,HDFC
1812,06-05-2020,1732.15,1777.55,1680,1709,8781437,42.25,0,42.25,52.10440638,1569.1,1927,45.55741827,-54.44258173,-13.39501636,-39.21719201,0.040861701,160014005,HDFC
1813,07-05-2020,1703.9,1745.95,1697.65,1730,3349484,-28.25,28.25,0,49.18990351,1569.1,1927,37.664152,-62.335848,-13.35206645,-34.0441669,0.024316932,156664521,HDFC
1814,08-05-2020,1689.7,1742,1685,1737,4420831,-14.2,14.2,0,47.64422868,1569.1,1927,33.69656329,-66.30343671,-14.29901947,-30.09513741,0.069227362,152243690,HDFC
1815,11-05-2020,1658.45,1722,1652.1,1712.5,4677500,-31.25,31.25,0,44.12358149,1569.1,1927,24.96507404,-75.03492596,-17.37085993,-27.55028192,0.042099972,147566190,HDFC
1816,12-05-2020,1674.1,1682.8,1587.1,1630,7019332,15.65,0,15.65,46.41178033,1569.1,1927,29.33780386,-70.66219614,-18.33118098,-25.70646173,-0.024303532,154585522,HDFC
1817,13-05-2020,1712.75,1749.5,1698,1747,5734243,38.65,0,38.65,52.01172113,1569.1,1927,40.13690975,-59.86309025,-15.79147604,-23.72346459,-0.067510549,160319765,HDFC
1818,14-05-2020,1632.4,1693,1628.1,1685,5424770,-80.35,80.35,0,41.58716231,1569.1,1927,17.68650461,-82.31349539,-20.03140548,-22.98505277,-0.148016701,154894995,HDFC
1819,15-05-2020,1633.8,1657.75,1609,1649,5610025,1.4,0,1.4,41.82158971,1585.35,1927,14.18117957,-85.81882043,-23.01332849,-22.99070791,-0.052512541,160505020,HDFC
1820,18-05-2020,1512.05,1637.65,1506.4,1633.5,8460262,-121.75,121.75,0,29.81492018,1506.4,1927,1.343319068,-98.65668093,-34.79958352,-25.35248303,-0.105242914,152044758,HDFC
1821,19-05-2020,1539.85,1591.75,1512,1570,9261076,27.8,0,27.8,34.750339,1506.4,1927,7.952924394,-92.04707561,-41.41958864,-28.56590415,-0.111018099,161305834,HDFC
1822,20-05-2020,1627,1640,1545,1550,6847043,87.15,0,87.15,47.98173287,1506.4,1927,28.67332382,-71.32667618,-39.18204748,-30.68913282,-0.045131757,168152877,HDFC
1823,21-05-2020,1597.3,1651.8,1590,1632.9,7056092,-29.7,29.7,0,44.43831866,1506.4,1856,26.00114416,-73.99885584,-39.35169988,-32.42164623,-0.054684263,161096785,HDFC
1824,22-05-2020,1516.15,1596.7,1501.5,1582,12034389,-81.15,81.15,0,36.04598297,1501.5,1777.55,5.3070096,-94.6929904,-45.50967028,-35.03925104,-0.085803009,149062396,HDFC
1825,26-05-2020,1502.15,1568.15,1486,1516,12752510,-14,14,0,34.73998566,1486,1777.55,5.539358601,-94.4606414,-50.93247135,-38.2178951,-0.102711905,136309886,HDFC
1826,27-05-2020,1570.4,1578,1490,1513,12428432,68.25,0,68.25,45.78840439,1486,1749.5,32.03036053,-67.96963947,-49.15623321,-40.40556272,-0.083111954,148738318,HDFC
1827,28-05-2020,1623.7,1643.8,1577,1580,10262028,53.3,0,53.3,52.96396913,1486,1749.5,52.25806452,-47.74193548,-42.95255679,-40.91496154,-0.005329576,159000346,HDFC
1828,29-05-2020,1658.9,1676.35,1590.9,1615.9,13809103,35.2,0,35.2,57.27345115,1486,1749.5,65.61669829,-34.38330171,-34.79466152,-39.69090153,0.015362958,172809449,HDFC
1829,01-06-2020,1737.7,1764.85,1701.3,1706.6,8056778,78.8,0,78.8,65.45005913,1486,1764.85,90.26358257,-9.736417429,-21.72058788,-36.0968388,0.149234483,180866227,HDFC
1830,02-06-2020,1813.55,1822.35,1732.15,1737.7,8319067,75.85,0,75.85,71.50628094,1486,1822.35,97.38367772,-2.616322283,-5.179127472,-29.91329654,0.177744586,189185294,HDFC
1831,03-06-2020,1835.65,1859.45,1823.1,1835.2,9490542,22.1,0,22.1,73.09198012,1486,1859.45,93.62699157,-6.373008435,9.602690537,-22.01009912,0.128242163,198675836,HDFC
1832,04-06-2020,1764.3,1828.4,1759,1815,7617538,-71.35,71.35,0,60.54116226,1486,1859.45,74.52135493,-25.47864507,15.38271672,-14.53153595,0.104551431,191058298,HDFC
1833,05-06-2020,1766.6,1788.95,1740.6,1775,6691738,2.3,0,2.3,60.79157904,1486,1859.45,75.1372339,-24.8627661,19.91940143,-7.641348476,0.165188141,197750036,HDFC
1834,08-06-2020,1760.8,1818.9,1748.35,1801,6209421,-5.8,5.8,0,59.68936945,1486,1859.45,73.58414781,-26.41585219,22.78410425,-1.556257931,0.172186533,191540615,HDFC
1835,09-06-2020,1772.1,1826.75,1746,1763.2,9065372,11.3,0,11.3,61.26802981,1486,1859.45,76.60998795,-23.39001205,25.67030613,3.889054881,0.128438614,200605987,HDFC
1836,10-06-2020,1809.3,1820,1782,1784,4631195,37.2,0,37.2,66.28362415,1486,1859.45,86.5711608,-13.4288392,30.60655767,9.232555438,0.11430683,205237182,HDFC
1837,11-06-2020,1787.45,1826,1781.35,1805,5383998,-21.85,21.85,0,60.93574768,1486,1859.45,80.72031062,-19.27968938,32.38217859,13.86248007,0.077491109,199853184,HDFC
1838,12-06-2020,1792.2,1809,1710,1710,5936632,4.75,0,4.75,61.71064341,1486,1859.45,81.99223457,-18.00776543,33.78322429,17.84662891,0.031363296,205789816,HDFC
1839,15-06-2020,1751.65,1805.25,1726,1786.95,5082387,-40.55,40.55,0,51.62373016,1490,1859.45,70.82149141,-29.17850859,31.26115782,20.52953469,-0.034131951,200707429,HDFC
1840,16-06-2020,1821.9,1834,1768.05,1785,7453412,70.25,0,70.25,63.53747569,1577,1859.45,86.70561161,-13.29438839,34.53291591,23.33021094,-0.007490535,208160841,HDFC
1841,17-06-2020,1794.65,1847.15,1786,1819,6816822,-27.25,27.25,0,57.22931727,1590.9,1859.45,75.87041519,-24.12958481,34.52893246,25.56995524,0.01720229,201344019,HDFC
1842,18-06-2020,1855.95,1869,1787.3,1790,5334835,61.3,0,61.3,65.99293878,1701.3,1869,92.21824687,-7.781753131,39.02234791,28.26043378,0.05057738,206678854,HDFC
1843,19-06-2020,1835.1,1867.5,1814,1854,12199449,-20.85,20.85,0,61.08116629,1710,1869,78.67924528,-21.32075472,40.43488312,30.69532364,0.042196729,194479405,HDFC
1844,22-06-2020,1819.4,1874.2,1813.1,1850.8,4782899,-15.7,15.7,0,57.3711499,1710,1874.2,66.62606577,-33.37393423,39.8283522,32.52192936,0.026691496,189696506,HDFC
1845,23-06-2020,1838.1,1845,1803.05,1820,5043383,18.7,0,18.7,60.65545082,1710,1874.2,78.01461632,-21.98538368,40.39100346,34.09574418,0.015917758,194739889,HDFC
1846,24-06-2020,1797.75,1869,1788.6,1825,7029207,-40.35,40.35,0,50.89321962,1710,1874.2,53.4409257,-46.5590743,37.15272733,34.70714081,0.005762399,187710682,HDFC
1847,25-06-2020,1777.8,1811,1761.9,1782.2,5939864,-19.95,19.95,0,46.61329314,1710,1874.2,41.2911084,-58.7088916,32.60077051,34.28586675,-0.008034818,181770818,HDFC
1848,26-06-2020,1769.35,1799.9,1752.4,1793.85,5731517,-8.45,8.45,0,44.77313315,1710,1874.2,36.14494519,-63.85505481,27.98882975,33.02645935,0.010104758,176039301,HDFC
1849,29-06-2020,1741.15,1775,1726.25,1755,3948941,-28.2,28.2,0,38.86506493,1710,1874.2,18.97076736,-81.02923264,21.80695218,30.78255792,-0.044321862,172090360,HDFC
1850,30-06-2020,1754.65,1792.7,1747.2,1751.15,6325246,13.5,0,13.5,43.01838442,1710,1874.2,27.19244823,-72.80755177,17.79201161,28.18444865,-0.022288469,178415606,HDFC
1851,01-07-2020,1835.15,1844.8,1760.4,1764,6991685,80.5,0,80.5,61.16908886,1710,1874.2,76.2180268,-23.7819732,20.86529735,26.72061839,-0.011207198,185407291,HDFC
1852,02-07-2020,1889.45,1899,1842.6,1852.95,6480519,54.3,0,54.3,68.88347926,1726,1899,94.47976879,-5.520231214,27.36698507,26.84989173,0.029616915,191887810,HDFC
1853,03-07-2020,1885.2,1908,1867.3,1905.55,4430264,-4.25,4.25,0,67.66938263,1726.25,1908,87.45529574,-12.54470426,31.80999414,27.84191221,0.036165769,187457546,HDFC
1854,06-07-2020,1868.7,1909.25,1864.55,1903.25,5073705,-16.5,16.5,0,62.71750533,1726.25,1909.25,77.84153005,-22.15846995,33.61223778,28.99597732,0.016647625,182383841,HDFC
1855,07-07-2020,1886.75,1892.35,1857,1880,4157365,18.05,0,18.05,65.87000503,1726.25,1909.25,87.70491803,-12.29508197,36.08109262,30.41300038,0.049506327,186541206,HDFC
1856,08-07-2020,1886.05,1907,1871,1895,2885754,-0.7,0.7,0,65.62171094,1726.25,1909.25,87.32240437,-12.67759563,37.5483596,31.84007223,0.060889864,183655452,HDFC
1857,09-07-2020,1941.85,1947.9,1865,1871.3,6703324,55.8,0,55.8,74.47233419,1726.25,1947.9,97.27047146,-2.729528536,42.72130827,34.01631943,0.09749343,190358776,HDFC
1858,10-07-2020,1886,1931.9,1876.25,1915,3853348,-55.85,55.85,0,57.40468164,1726.25,1947.9,72.0730882,-27.9269118,41.83206511,35.57946857,0.083192143,186505428,HDFC
1859,13-07-2020,1845.55,1907.2,1840,1905,3403604,-40.45,40.45,0,48.17754863,1726.25,1947.9,53.82359576,-46.17640424,37.43186531,35.94994792,0.051805203,183101824,HDFC
1860,14-07-2020,1791.6,1825.3,1770.5,1825,5529793,-53.95,53.95,0,38.62342105,1726.25,1947.9,29.48341981,-70.51658019,29.25413765,34.61078586,-0.02373103,177572031,HDFC
1861,15-07-2020,1789.9,1821.9,1782,1809,3994980,-1.7,1.7,0,38.34692921,1726.25,1947.9,28.71644485,-71.28355515,22.37809305,32.1642473,-0.05268729,173577051,HDFC
1862,16-07-2020,1787.8,1794.7,1750,1792,4230162,-2.1,2.1,0,37.95960775,1726.25,1947.9,27.76900519,-72.23099481,16.56833625,29.04506509,-0.051665606,169346889,HDFC
1863,17-07-2020,1805.85,1821.95,1784.05,1800,4240987,18.05,0,18.05,43.60846629,1747.2,1947.9,29.22272048,-70.77727952,13.26760558,25.88957319,-0.033633007,173587876,HDFC
1864,20-07-2020,1806.05,1844,1801,1844,3915997,0.2,0,0.2,43.67403483,1750,1947.9,28.32238504,-71.67761496,10.54631966,22.82092248,-0.042771962,177503873,HDFC
1865,21-07-2020,1883.65,1900.95,1815,1816.5,6884035,77.6,0,77.6,62.95681206,1750,1947.9,67.53410814,-32.46589186,14.48438545,21.15361508,-0.001272501,184387908,HDFC
1866,22-07-2020,1881.05,1898.95,1851.5,1895.5,5538884,-2.6,2.6,0,62.13446893,1750,1947.9,66.22031329,-33.77968671,17.19729301,20.36235066,-0.031310348,178849024,HDFC
1867,23-07-2020,1875.8,1910,1871.6,1881.05,3647242,-5.25,5.25,0,60.29938029,1750,1947.9,63.56745831,-36.43254169,18.70800642,20.03148181,-0.005408271,175201782,HDFC
1868,24-07-2020,1841.3,1857.8,1817,1854,3309356,-34.5,34.5,0,49.2666046,1750,1947.9,46.13441132,-53.86558868,16.92628038,19.41044153,-0.002302837,171892426,HDFC
1869,27-07-2020,1850.75,1861.95,1824,1841.3,3724639,9.45,0,9.45,52.03999966,1750,1947.9,50.90955028,-49.09044972,16.09129525,18.74661227,0.033015182,175617065,HDFC
1870,28-07-2020,1897.35,1907,1844.5,1859.35,4346193,46.6,0,46.6,63.41842617,1750,1947.9,74.45679636,-25.54320364,18.97110695,18.79151121,0.060031287,179963258,HDFC
1871,29-07-2020,1877.3,1918.5,1867.2,1885,7413828,-20.05,20.05,0,56.73594572,1750,1931.9,69.98350742,-30.01649258,19.41174453,18.91555787,0.050061528,172549430,HDFC
1872,30-07-2020,1810.65,1900.7,1804,1880,7473426,-66.65,66.65,0,40.40554373,1750,1918.5,35.99406528,-64.00593472,14.21894782,17.97623586,0.002658028,165076004,HDFC
1873,31-07-2020,1781.95,1811.2,1759,1805,7746014,-28.7,28.7,0,35.35010414,1750,1918.5,18.96142433,-81.03857567,7.699019373,15.92079256,-0.013344038,157329990,HDFC
1874,03-08-2020,1739.8,1781.95,1730.1,1781,4648927,-42.15,42.15,0,29.16621576,1730.1,1918.5,5.148619958,-94.85138004,-0.859317952,12.56477046,-0.07636769,152681063,HDFC
1875,04-08-2020,1781.1,1794.45,1743.4,1749,4722583,41.3,0,41.3,40.86219357,1730.1,1918.5,27.07006369,-72.92993631,-4.2601883,9.199778708,-0.053135217,157403646,HDFC
1876,05-08-2020,1776.7,1811.5,1766.25,1784.4,5576455,-4.4,4.4,0,40.04928557,1730.1,1918.5,24.73460722,-75.26539278,-7.227135858,5.914395795,-0.052830792,151827191,HDFC
1877,06-08-2020,1783.75,1805.7,1762.05,1798.25,6004624,7.05,0,7.05,42.17601426,1730.1,1918.5,28.47664544,-71.52335456,-8.906913735,2.950133889,-0.031255092,157831815,HDFC
1878,07-08-2020,1777.7,1781.8,1763,1774.95,5129995,-6.05,6.05,0,40.74480182,1730.1,1918.5,25.26539278,-74.73460722,-10.60409682,0.239287748,-0.039470485,152701820,HDFC
1879,10-08-2020,1798.95,1811,1789.3,1794,3030917,21.25,0,21.25,47.90878446,1730.1,1918.5,36.54458599,-63.45541401,-10.11779756,-1.832129313,-0.051861807,155732737,HDFC
1880,11-08-2020,1826.75,1846.75,1810.5,1813,4944312,27.8,0,27.8,55.94821596,1730.1,1918.5,51.30042463,-48.69957537,-7.403827509,-2.946468952,-0.02692697,160677049,HDFC
1881,12-08-2020,1814.2,1837.7,1802,1825.75,3606317,-12.55,12.55,0,51.78515328,1730.1,1918.5,44.63906582,-55.36093418,-6.194263198,-3.596027801,0.001960622,157070732,HDFC
1882,13-08-2020,1804.85,1823.65,1799.55,1818.5,3769538,-9.35,9.35,0,48.67185725,1730.1,1918.5,39.67622081,-60.32377919,-5.921877904,-4.061197822,0.01285109,153301194,HDFC
1883,14-08-2020,1791.7,1823.75,1773.25,1818.6,6136766,-13.15,13.15,0,44.34546026,1730.1,1918.5,32.69639066,-67.30360934,-6.689987683,-4.586955794,0.029831015,147164428,HDFC
1884,17-08-2020,1800.55,1807.85,1783.85,1805,4076960,8.85,0,8.85,47.9390304,1730.1,1918.5,37.39384289,-62.60615711,-6.509561012,-4.971476838,0.010920218,151241388,HDFC
1885,18-08-2020,1820.7,1825.4,1795.95,1801.1,3413536,20.15,0,20.15,55.48940675,1730.1,1900.7,53.1066823,-46.8933177,-4.686610646,-4.9145036,0.024765014,154654924,HDFC
1886,19-08-2020,1827.95,1835.9,1818.05,1835,2934730,7.25,0,7.25,58.01718386,1730.1,1846.75,83.88341192,-16.11658808,-2.626616933,-4.456926266,0.024779257,157589654,HDFC
1887,20-08-2020,1785.15,1807.95,1782.25,1803,2702815,-42.8,42.8,0,41.83414812,1730.1,1846.75,47.19245607,-52.80754393,-4.396973803,-4.444935774,0.004190808,154886839,HDFC
1888,21-08-2020,1804.05,1824.7,1787.15,1800,3466213,18.9,0,18.9,49.0722367,1743.4,1846.75,58.68408321,-41.31591679,-4.226205267,-4.401189672,0.002834987,158353052,HDFC
1889,24-08-2020,1829.85,1849,1811,1814.95,3816127,25.8,0,25.8,57.41834709,1762.05,1849,77.97584819,-22.02415181,-1.986130713,-3.91817788,0.001697003,162169179,HDFC
1890,25-08-2020,1829.6,1852.4,1817.05,1843.75,2646159,-0.25,0.25,0,57.31333159,1762.05,1852.4,74.76480354,-25.23519646,-0.228395598,-3.180221424,0.00848859,159523020,HDFC
1891,26-08-2020,1816,1837.8,1803.6,1837,3187424,-13.6,13.6,0,51.41122001,1763,1852.4,59.28411633,-40.71588367,0.066449812,-2.530887177,0.006177799,156335596,HDFC
1892,27-08-2020,1864.1,1883,1830,1832,8648531,48.1,0,48.1,65.78852848,1773.25,1883,82.77904328,-17.22095672,4.133733824,-1.197962977,0.040408551,164984127,HDFC
1893,28-08-2020,1883.25,1889,1862.8,1871,4903981,19.15,0,19.15,69.88239467,1773.25,1889,95.03239741,-4.967602592,8.800879603,0.801805539,0.04593041,169888108,HDFC
1894,31-08-2020,1832.6,1921.9,1797.55,1898.5,7604691,-50.65,50.65,0,51.18871823,1773.25,1921.9,39.92600067,-60.07399933,8.316724533,2.304789338,0.006535948,162283417,HDFC
1895,01-09-2020,1851.2,1884,1831.85,1858,3793458,18.6,0,18.6,56.1580522,1773.25,1921.9,52.43861419,-47.56138581,9.326383957,3.709108262,0.012719166,166076875,HDFC
1896,02-09-2020,1827.2,1849.95,1810,1849.85,4235148,-24,24,0,48.76635049,1773.25,1921.9,36.29330642,-63.70669358,8.096614173,4.586609444,0.023555444,161841727,HDFC
1897,03-09-2020,1808.75,1842.8,1803.45,1831,3350617,-18.45,18.45,0,43.66801004,1782.25,1921.9,18.97601146,-81.02398854,5.569055349,4.783098625,0.002605249,158491110,HDFC
1898,04-09-2020,1769.7,1789,1761.8,1783.6,4214148,-39.05,39.05,0,34.78641731,1761.8,1921.9,4.93441599,-95.06558401,0.410209485,3.908520797,-0.032871547,154276962,HDFC
1899,07-09-2020,1791.1,1801.45,1760,1773,4073465,21.4,0,21.4,42.21768692,1760,1921.9,19.20938851,-80.79061149,-1.929173564,2.740981925,-0.021042851,158350427,HDFC
1900,08-09-2020,1777.3,1793.25,1770.8,1785.1,2456321,-13.8,13.8,0,38.91788824,1760,1921.9,10.6856084,-89.3143916,-4.840893349,1.22460687,-0.021310573,155894106,HDFC
1901,09-09-2020,1760.75,1777.9,1755,1759.55,2509630,-16.55,16.55,0,35.11943055,1755,1921.9,3.445176753,-96.55482325,-8.387216333,-0.697757771,-0.055442305,153384476,HDFC
1902,10-09-2020,1777.45,1792.95,1760,1781,3245630,16.7,0,16.7,41.73999372,1755,1921.9,13.45116836,-86.54883164,-9.737899966,-2.50578621,-0.056179477,156630106,HDFC
1903,11-09-2020,1768.15,1786,1760,1771,2232185,-9.3,9.3,0,39.17157571,1755,1921.9,7.878969443,-92.12103056,-11.42703501,-4.290035969,-0.035168613,154397921,HDFC
1904,14-09-2020,1738,1796.85,1728.4,1781,4061493,-30.15,30.15,0,31.84217691,1728.4,1921.9,4.96124031,-95.03875969,-15.02533699,-6.437096173,-0.061149525,150336428,HDFC
1905,15-09-2020,1758.75,1777,1742.8,1754.9,3159537,20.75,0,20.75,40.65933117,1728.4,1921.9,15.68475452,-84.31524548,-16.01801989,-8.353280916,-0.03746169,153495965,HDFC
1906,16-09-2020,1768.15,1774.7,1743.45,1766,2592551,9.4,0,9.4,44.41776083,1728.4,1921.9,20.54263566,-79.45736434,-15.86336381,-9.855297496,-0.022446441,156088516,HDFC
1907,17-09-2020,1744.35,1773.2,1736.5,1750,3191905,-23.8,23.8,0,37.48227428,1728.4,1921.9,8.242894057,-91.75710594,-17.45999095,-11.37623619,-0.014324462,152896611,HDFC
1908,18-09-2020,1724,1754.75,1708.3,1752.9,5642506,-20.35,20.35,0,32.47896033,1708.3,1884,8.935685828,-91.06431417,-20.13529721,-13.12804839,-0.037463012,147254105,HDFC
1909,21-09-2020,1708.15,1738.75,1701.85,1722.8,3174505,-15.85,15.85,0,29.00004934,1701.85,1849.95,4.253882512,-95.74611749,-23.26626027,-15.15569077,-0.038907331,144079600,HDFC
1910,22-09-2020,1674.85,1716.25,1672,1716.25,3615745,-33.3,33.3,0,23.02213522,1672,1842.8,1.668618267,-98.33138173,-28.11056169,-17.74666495,-0.048786029,140463855,HDFC
1911,23-09-2020,1667.1,1696.65,1650.4,1694,4803637,-7.75,7.75,0,21.81459009,1650.4,1801.45,11.05594174,-88.94405826,-32.20383988,-20.63809994,-0.062083322,135660218,HDFC
1912,24-09-2020,1636.85,1654.15,1623,1646.8,5673754,-30.25,30.25,0,17.64610533,1623,1801.45,7.761277669,-92.23872233,-37.45693431,-24.00186681,-0.074258406,129986464,HDFC
1913,25-09-2020,1652,1657.8,1628.1,1651.95,4046773,15.15,0,15.15,25.8356799,1623,1796.85,16.68104688,-83.31895312,-39.93719992,-27.18893343,-0.049482163,134033237,HDFC
1914,28-09-2020,1681.45,1692.6,1658,1672.9,2739071,29.45,0,29.45,39.36105731,1623,1796.85,33.62093759,-66.37906241,-39.07601543,-29.56634983,-0.04395167,136772308,HDFC
1915,29-09-2020,1713.1,1720,1682.1,1692,3696138,31.65,0,31.65,50.54512534,1623,1796.85,51.82628703,-48.17371297,-35.43120119,-30.7393201,-0.031134236,140468446,HDFC
1916,30-09-2020,1740.05,1744.25,1703.2,1716.9,3594715,26.95,0,26.95,58.13200662,1623,1796.85,67.32815646,-32.67184354,-30.02194558,-30.5958452,-0.002465102,144063161,HDFC
1917,01-10-2020,1790.65,1799.85,1750,1755,3706206,50.6,0,50.6,68.57579632,1623,1799.85,94.79785129,-5.202148714,-21.40532713,-28.75774158,0.038660093,147769367,HDFC
1918,05-10-2020,1785.1,1816.5,1775.7,1784,4056801,-5.55,5.55,0,66.47715243,1623,1816.5,83.77260982,-16.22739018,-14.85321493,-25.97683625,0.045048737,143712566,HDFC
1919,06-10-2020,1934.4,1943.7,1803.15,1803.15,16829628,149.3,0,149.3,82.80800581,1623,1943.7,97.10009355,-2.899906455,2.359445227,-20.30957996,0.154969102,160542194,HDFC
1920,07-10-2020,1948.75,1964.85,1908.85,1945,7038044,14.35,0,14.35,83.68922236,1623,1964.85,95.29033202,-4.709667983,16.96298871,-12.85506622,0.168946074,167580238,HDFC
1921,08-10-2020,1949.25,1988.45,1938.5,1952.5,4589506,0.5,0,0.5,83.72276545,1623,1988.45,89.27349843,-10.72650157,28.25108701,-4.633835578,0.190854385,172169744,HDFC
1922,09-10-2020,1957.65,2029.85,1938,1945,10848230,8.4,0,8.4,84.34677242,1623,2029.85,82.25390193,-17.74609807,37.44317442,3.781566423,0.18501816,183017974,HDFC
1923,12-10-2020,1965.4,1998.95,1942.3,1965,3651557,7.75,0,7.75,84.9605501,1623,2029.85,84.15878088,-15.84121912,44.83648309,11.99254976,0.168872104,186669531,HDFC
1924,13-10-2020,1943.4,1986.65,1930.55,1962,3351027,-22,22,0,75.29074592,1623,2029.85,78.75138257,-21.24861743,48.36301856,19.26664352,0.134434651,183318504,HDFC
1925,14-10-2020,1979.85,1989,1919.05,1935,3108218,36.45,0,36.45,79.7062929,1623,2029.85,87.7104584,-12.2895416,53.48252051,26.10981892,0.137812132,186426722,HDFC
1926,15-10-2020,1947.2,2020,1938.25,1983,5170267,-32.65,32.65,0,67.27993162,1628.1,2029.85,79.42750467,-20.57249533,54.27948048,31.74375123,0.087426354,181256455,HDFC
1927,16-10-2020,1961.7,1983.7,1939.35,1948.4,3238617,14.5,0,14.5,69.70051133,1658,2029.85,81.67271749,-18.32728251,55.4420049,36.48340196,0.098930032,184495072,HDFC
1928,19-10-2020,2031.5,2039.9,1983.1,1985,6591617,69.8,0,69.8,78.52477153,1682.1,2039.9,97.65231973,-2.347680268,61.28908808,41.44453919,0.050196443,191086689,HDFC
1929,20-10-2020,2015.3,2041.7,2004.05,2025,4733065,-16.2,16.2,0,72.84355141,1703.2,2041.7,92.20088626,-7.799113737,63.87937732,45.93150681,0.034150096,186353624,HDFC
1930,21-10-2020,2048.75,2067.45,2005.35,2030,8166501,33.45,0,33.45,76.83629934,1750,2067.45,94.10930855,-5.890691447,67.84921216,50.31504788,0.051045274,194520125,HDFC
1931,22-10-2020,2042.55,2063,2023.15,2038.3,5030745,-6.2,6.2,0,74.49388866,1775.7,2067.45,91.46529563,-8.53470437,69.69168434,54.19037517,0.043368324,189489380,HDFC
1932,23-10-2020,2059.7,2067.9,2046,2056,3573911,17.15,0,17.15,76.75559101,1803.15,2067.9,96.90273843,-3.097261568,71.70910061,57.69412026,0.047980055,193063291,HDFC
1933,26-10-2020,2073.35,2083.95,2052.75,2058,4927520,13.65,0,13.65,78.50594537,1908.85,2083.95,93.94631639,-6.053683609,73.56138856,60.86757392,0.066867346,197990811,HDFC
1934,27-10-2020,2041.35,2064.8,2027,2056,4468948,-32,32,0,65.2209902,1919.05,2083.95,74.16616131,-25.83383869,71.62159834,63.01837881,0.031062959,193521863,HDFC
1935,28-10-2020,1968.9,2045,1965,2045,4636738,-72.45,72.45,0,45.22724997,1919.05,2083.95,30.23044269,-69.76955731,63.50613195,63.11592944,0.011144207,188885125,HDFC
1936,29-10-2020,1934.3,1970,1927.3,1941.25,3463664,-34.6,34.6,0,38.69134023,1919.05,2083.95,9.248029109,-90.75197089,53.66403,61.22554955,-0.013967477,185421461,HDFC
1937,30-10-2020,1923.55,1947,1906.85,1930,4322115,-10.75,10.75,0,36.78559883,1906.85,2083.95,9.429700734,-90.57029927,44.48387571,57.87721478,-0.053138075,181099346,HDFC
1938,02-11-2020,2040.8,2065,1916,1916,7635981,117.25,0,117.25,60.97569741,1906.85,2083.95,75.63523433,-24.36476567,46.13778473,55.52932877,0.012653203,188735327,HDFC
1939,03-11-2020,2130.95,2139.65,2030,2030,8905106,90.15,0,90.15,70.86621989,1906.85,2139.65,96.2628866,-3.737113402,54.09924866,55.24331275,0.040122026,197640433,HDFC
1940,04-11-2020,2088.2,2134.95,2056.4,2111.1,5214238,-42.75,42.75,0,62.23561275,1906.85,2139.65,77.89948454,-22.10051546,56.3100908,55.45666836,0.022349514,192426195,HDFC
1941,05-11-2020,2100.7,2120,2084.3,2106,4117187,12.5,0,12.5,63.7260666,1906.85,2139.65,83.26890034,-16.73109966,58.39767263,56.04486921,0.019905812,196543382,HDFC
1942,06-11-2020,2138.45,2145,2102.45,2110,4607710,37.75,0,37.75,68.11161106,1906.85,2145,97.24963258,-2.750367415,62.37913791,57.31172295,0.031398461,201151092,HDFC
1943,09-11-2020,2152.1,2169.95,2138.2,2150,3529739,13.65,0,13.65,69.64288525,1906.85,2169.95,93.21550741,-6.784492588,65.87653506,59.02468537,0.054253313,204680831,HDFC
1944,10-11-2020,2272.1,2288.8,2175.55,2185,8512622,120,0,120,79.58634709,1906.85,2288.8,95.62769996,-4.372300039,77.43858086,62.70746447,0.153994616,213193453,HDFC
1945,11-11-2020,2324.3,2337,2273,2279,7235313,52.2,0,52.2,82.46859313,1906.85,2337,97.04754156,-2.952458445,89.77877537,68.12172665,0.201623326,220428766,HDFC
1946,12-11-2020,2332.1,2343.8,2267.45,2297.25,6398213,7.8,0,7.8,82.88522597,1906.85,2343.8,97.32234809,-2.677651905,99.0461212,74.30660556,0.212393751,226826979,HDFC
1947,13-11-2020,2306.75,2323.3,2284,2320,3999928,-25.35,25.35,0,76.10303554,1906.85,2343.8,91.52076897,-8.479231033,103.1559093,80.07646631,0.130316543,222827051,HDFC
1948,14-11-2020,2311.25,2329.35,2304,2320,374286,4.5,0,4.5,76.49694787,1906.85,2343.8,92.55063508,-7.449364916,105.5592372,85.17302048,0.08461015,223201337,HDFC
1949,17-11-2020,2349,2364.75,2307.4,2339.9,7393052,37.75,0,37.75,79.73096463,1906.85,2364.75,96.56038436,-3.439615637,109.2506281,89.98854201,0.124892252,230594389,HDFC
1950,18-11-2020,2364.9,2369.4,2320.3,2336.7,4344487,15.9,0,15.9,81.00144141,1906.85,2369.4,99.0271322,-0.972867798,112.1660982,94.42405325,0.125767601,234938876,HDFC
1951,19-11-2020,2324.6,2351.9,2311,2336,6936896,-40.3,40.3,0,68.45319101,1916,2369.4,90.11910013,-9.880899868,109.9572374,97.53069009,0.087049031,228001980,HDFC
1952,20-11-2020,2334.8,2386.55,2326.55,2330,5321688,10.2,0,10.2,69.81863033,2030,2386.55,85.4859066,-14.5140934,107.7872498,99.58200203,0.084893825,233323668,HDFC
1953,23-11-2020,2250.8,2347.85,2230.1,2344.2,6995598,-84,84,0,49.47163602,2056.4,2386.55,58.88232622,-41.11767378,98.15791764,99.29718515,-0.009374587,226328070,HDFC
1954,24-11-2020,2217.7,2272.25,2209.55,2272.25,4945274,-33.1,33.1,0,43.68344995,2084.3,2386.55,44.1356493,-55.8643507,86.85450448,96.80864902,-0.045863271,221382796,HDFC
1955,25-11-2020,2191.35,2252.15,2179.3,2228,6150483,-26.35,26.35,0,39.4443686,2102.45,2386.55,31.29179866,-68.70820134,74.90676477,92.42827217,-0.06035333,215232313,HDFC
1956,26-11-2020,2238.4,2245,2187.65,2197.15,5026304,47.05,0,47.05,49.53410299,2138.2,2386.55,40.34628548,-59.65371452,68.44563805,87.63174534,-0.029630432,220258617,HDFC
1957,27-11-2020,2256.25,2272.45,2202.2,2240,10179511,17.85,0,17.85,52.96474351,2175.55,2386.55,38.2464455,-61.7535545,64.02742608,82.91088149,-0.023796647,230438128,HDFC
1958,01-12-2020,2306.95,2324,2217.65,2237,7031670,50.7,0,50.7,61.53446389,2179.3,2386.55,61.59227986,-38.40772014,63.88065117,79.10483543,-0.017901235,237469798,HDFC
1959,02-12-2020,2276.35,2304,2252.5,2300,3191550,-30.6,30.6,0,54.60588793,2179.3,2386.55,46.82750302,-53.17249698,60.5966463,75.4031976,-0.037443444,234278248,HDFC
1960,03-12-2020,2253.95,2289.45,2235,2287,4528707,-22.4,22.4,0,49.86364217,2179.3,2386.55,36.01930036,-63.98069964,55.54625336,71.43180876,-0.030392326,229749541,HDFC
1961,04-12-2020,2245.9,2284.9,2231.6,2253.95,3245440,-8.05,8.05,0,48.13039778,2179.3,2386.55,32.13510253,-67.86489747,50.31422182,67.20829137,-0.038076066,226504101,HDFC
1962,07-12-2020,2303.8,2309.7,2221.2,2240,4910736,57.9,0,57.9,59.74337882,2179.3,2386.55,60.07237636,-39.92762364,50.26047378,63.81872785,0.023547183,231414837,HDFC
1963,08-12-2020,2309.75,2340,2292.05,2315,5262959,5.95,0,5.95,60.78443831,2179.3,2386.55,62.94330519,-37.05669481,50.12023844,61.07902997,0.041506967,236677796,HDFC
1964,09-12-2020,2306.7,2334.65,2280.6,2318,3302661,-3.05,3.05,0,59.86870529,2179.3,2386.55,61.47165259,-38.52834741,49.19589179,58.70240233,0.052638784,233375135,HDFC
1965,10-12-2020,2289.1,2303,2267,2300,2545081,-17.6,17.6,0,54.41084206,2179.3,2386.55,52.97949337,-47.02050663,46.50706302,56.26333447,0.022650107,230830054,HDFC
1966,11-12-2020,2295.9,2317.7,2272,2307,4577813,6.8,0,6.8,56.19128259,2179.3,2347.85,69.17828538,-30.82171462,44.41288593,53.89324476,0.017573407,235407867,HDFC
1967,14-12-2020,2302.65,2315.65,2270.55,2306.7,3160235,6.75,0,6.75,58.0669884,2179.3,2340,76.75793404,-23.24206596,42.80448067,51.67549194,-0.001863933,238568102,HDFC
1968,15-12-2020,2350.35,2357.4,2282.7,2290.5,5056502,47.7,0,47.7,68.91810048,2179.3,2357.4,96.04154969,-3.958450309,44.86166195,50.31272594,0.032508182,243624604,HDFC
1969,16-12-2020,2424.65,2443.4,2365.5,2377.95,6532346,74.3,0,74.3,78.78498243,2187.65,2443.4,92.6686217,-7.331378299,51.88923519,50.62802779,0.075733712,250156950,HDFC
1970,17-12-2020,2494.6,2509,2420.15,2434.9,7379515,69.95,0,69.95,84.22489063,2202.2,2509,95.30638853,-4.693611473,62.3838953,52.97920129,0.110735117,257536465,HDFC
1971,18-12-2020,2479.4,2489,2431,2482,4189517,-15.2,15.2,0,79.13706862,2217.65,2509,89.84039815,-10.15960185,68.68274416,56.11990987,0.076221894,253346948,HDFC
1972,21-12-2020,2414.8,2478.95,2370.45,2468,3573982,-64.6,64.6,0,61.05174216,2221.2,2509,67.26893676,-32.73106324,67.68175401,58.4322787,0.045481113,249772966,HDFC
1973,22-12-2020,2403.65,2439.9,2360.5,2415,4832004,-11.15,11.15,0,58.39404665,2221.2,2509,63.39471855,-36.60528145,65.23674175,59.79317131,0.042029739,244940962,HDFC
1974,23-12-2020,2403.05,2419.65,2376.75,2398,2605828,-0.6,0.6,0,58.23663831,2221.2,2509,63.18624044,-36.81375956,62.52983195,60.34050343,0.049779389,242335134,HDFC
1975,24-12-2020,2455.15,2464.65,2411.05,2417,2723426,52.1,0,52.1,67.11755277,2221.2,2509,81.28908965,-18.71091035,63.85256835,61.04291642,0.069362777,245058560,HDFC
1976,28-12-2020,2476.45,2485,2436.6,2467,2085391,21.3,0,21.3,70.1153371,2267,2509,86.54958678,-13.45041322,65.86038099,62.00640933,0.075478253,247143951,HDFC
1977,29-12-2020,2518.95,2530,2480,2480,4490464,42.5,0,42.5,75.29970317,2267,2530,95.79847909,-4.201520913,70.07322131,63.61977173,0.071733997,251634415,HDFC
1978,30-12-2020,2518.05,2525,2483,2518.95,2902423,-0.9,0.9,0,74.98186575,2267,2530,95.45627376,-4.543726236,72.50352958,65.3965233,0.038521024,248731992,HDFC
1979,31-12-2020,2558.65,2575,2504.4,2518.7,4956399,40.6,0,40.6,79.48840048,2270.55,2575,94.62966004,-5.370339957,76.82011264,67.68124117,0.025675459,253688391,HDFC
1980,01-01-2021,2568.75,2593.3,2541.15,2549,2054108,10.1,0,10.1,80.49680948,2270.55,2593.3,92.39349342,-7.606506584,80.13230607,70.17145415,0.036036944,255742499,HDFC
1981,04-01-2021,2578.5,2592.35,2533.15,2576.9,2795972,9.75,0,9.75,81.50936791,2282.7,2593.3,95.23502898,-4.764971024,82.59191851,72.65554702,0.067790293,258538471,HDFC
1982,05-01-2021,2651.85,2659.45,2572.4,2589,5870743,73.35,0,73.35,87.25372219,2360.5,2659.45,97.45776886,-2.542231142,89.4290289,76.0102434,0.103259626,264409214,HDFC
1983,06-01-2021,2638.85,2665,2619,2664.7,3401085,-13,13,0,82.04159849,2360.5,2665,91.41215107,-8.587848933,92.72956806,79.35410833,0.098125299,261008129,HDFC
1984,07-01-2021,2661.35,2709.35,2647.4,2670,4106042,22.5,0,22.5,83.95559618,2360.5,2709.35,86.24050451,-13.75949549,96.05358514,82.69400369,0.083986722,265114171,HDFC
1985,08-01-2021,2657.5,2674.4,2631,2668,4497042,-3.85,3.85,0,82.22535905,2360.5,2709.35,85.13687831,-14.86312169,97.25612176,85.6064273,0.073108684,260617129,HDFC
1986,11-01-2021,2751.2,2762,2666.75,2680,5939812,93.7,0,93.7,88.74124158,2360.5,2762,97.31008717,-2.689912827,104.5645921,89.39806026,0.092201116,266556941,HDFC
1987,12-01-2021,2747.55,2760,2719,2738,3412213,-3.65,3.65,0,87.30276893,2376.75,2762,96.24918884,-3.750811162,108.8078142,93.28001106,0.091141955,263144728,HDFC
1988,13-01-2021,2670.9,2777.15,2651.1,2760.45,5582165,-76.65,76.65,0,62.6826292,2411.05,2777.15,70.9778749,-29.0221251,104.777771,95.57956305,0.043870791,257562563,HDFC
1989,14-01-2021,2684.05,2699,2647.15,2670,4253567,13.15,0,13.15,64.65570306,2436.6,2777.15,72.6618705,-27.3381295,101.4752839,96.75870723,0.044885645,261816130,HDFC
1990,15-01-2021,2632.75,2688.45,2615.6,2661,2582955,-51.3,51.3,0,52.22605006,2480,2777.15,51.4050143,-48.5949857,93.63914409,96.1347946,0.021039364,259233175,HDFC
1991,18-01-2021,2566.5,2647.4,2550,2645.95,5154593,-66.25,66.25,0,40.59661925,2483,2777.15,28.38687744,-71.61312256,81.14770525,93.13737673,-0.032185078,254078582,HDFC
1992,19-01-2021,2656.95,2680.8,2575,2585,3569359,90.45,0,90.45,56.02309012,2504.4,2777.15,55.93033914,-44.06966086,77.65158986,90.04021936,0.006859048,257647941,HDFC
1993,20-01-2021,2688.15,2711.9,2622.6,2666,5771114,31.2,0,31.2,60.14270975,2533.15,2777.15,63.52459016,-36.47540984,76.5164386,87.33546321,0.010070077,263419055,HDFC
1994,21-01-2021,2663,2698,2641.25,2687.95,3200138,-25.15,25.15,0,55.32250436,2533.15,2777.15,53.21721311,-46.78278689,72.74882507,84.41813558,0.002069614,260218917,HDFC
1995,22-01-2021,2589.45,2678.75,2583.05,2669,5013872,-73.55,73.55,0,43.54585021,2550,2777.15,17.36737838,-82.63262162,63.10070819,80.1546501,-0.058792527,255205045,HDFC
1996,25-01-2021,2551.4,2670,2543,2630.45,7761405,-38.05,38.05,0,38.63636214,2543,2777.15,3.587443946,-96.41255605,51.78721824,74.48116373,-0.071390876,247443640,HDFC
1997,27-01-2021,2467,2546.3,2458.25,2546.3,4858346,-84.4,84.4,0,29.98430911,2458.25,2777.15,2.743806836,-97.25619316,35.60044158,66.7050193,-0.076341308,242585294,HDFC
1998,28-01-2021,2425.75,2454,2395.25,2430.1,5282970,-41.25,41.25,0,26.62230656,2395.25,2777.15,7.98638387,-92.01361613,19.22219272,57.20845398,-0.096235167,237302324,HDFC
1999,29-01-2021,2377.8,2460,2364.6,2450,7347695,-47.95,47.95,0,23.14200038,2364.6,2777.15,3.199612168,-96.80038783,2.346103812,46.23598395,-0.096837907,229954629,HDFC
2000,01-02-2021,2579.25,2602.1,2391.85,2402.7,7106502,201.45,0,201.45,52.95525793,2364.6,2777.15,52.03005696,-47.96994304,5.167446077,38.02227637,0.004967855,237061131,HDFC
